//MAP CONVERTED BY dmm2tgm.py THIS HEADER COMMENT PREVENTS RECONVERSION, DO NOT REMOVE
"a" = (
/turf/open/floor/plating/asteroid/wasteplanet/lit,
/area/space)
"c" = (
/obj/structure/railing{
	dir = 8
	},
/obj/structure/railing{
	dir = 6
	},
/turf/open/floor/plasteel/dark,
/area/space)
"d" = (
/obj/structure/lattice/catwalk,
/turf/open/floor/plating,
/area/space)
"e" = (
/obj/machinery/door/poddoor/shutters/preopen{
	dir = 8
	},
/turf/open/floor/plating,
/area/space)
"f" = (
/obj/machinery/computer/helm{
	dir = 8
	},
/turf/open/floor/hangar/plasteel,
/area/space)
"i" = (
/turf/open/space/basic,
/area/space)
"k" = (
/obj/structure/stairs/north,
/turf/open/floor/plasteel/dark,
/area/space)
"p" = (
/turf/open/floor/plasteel/mono,
/area/space)
"q" = (
/turf/open/floor/plasteel/stairs{
	dir = 4
	},
/area/space)
"r" = (
/obj/structure/catwalk/over/plated_catwalk,
/obj/machinery/door/airlock{
	name = "Crew Quarters";
	dir = 4
	},
/turf/open/floor/plating,
/area/space)
"t" = (
/obj/structure/catwalk/over/plated_catwalk,
/turf/open/floor/plating,
/area/space)
"u" = (
/obj/structure/chair/comfy/beige/directional/east,
/turf/open/floor/hangar/plasteel,
/area/space)
"x" = (
/obj/structure/railing{
	dir = 4
	},
/turf/open/floor/plasteel/dark,
/area/space)
"z" = (
/turf/open/floor/plating,
/area/space)
"A" = (
/obj/machinery/door/airlock/engineering{
	dir = 4
	},
/turf/open/floor/plating,
/area/space)
"B" = (
/obj/structure/grille,
/obj/structure/window/reinforced/fulltile,
/turf/open/floor/plating,
/area/space)
"C" = (
/turf/closed/wall/r_wall,
/area/space)
"E" = (
/obj/machinery/computer/helm{
	dir = 8
	},
/turf/open/floor/plating,
/area/space)
"F" = (
/obj/machinery/door/airlock{
	name = "Crew Quarters";
	dir = 4
	},
/turf/open/floor/hangar/plasteel,
/area/space)
"G" = (
/obj/machinery/door/poddoor/shutters,
/turf/open/floor/plasteel/mono,
/area/space)
"K" = (
/turf/open/floor/plasteel/dark,
/area/space)
"L" = (
/obj/machinery/door/poddoor/shutters{
	dir = 4
	},
/turf/open/floor/plating,
/area/space)
"M" = (
/turf/open/floor/pod,
/area/space)
"N" = (
/turf/open/floor/hangar/plasteel,
/area/space)
"O" = (
/obj/structure/chair/comfy/beige/directional/east,
/turf/open/floor/plasteel/dark,
/area/space)
"P" = (
/obj/structure/window/reinforced/fulltile,
/obj/structure/grille,
/turf/open/floor/plating,
/area/space)
"Q" = (
/obj/machinery/computer/secure_data/laptop,
/obj/structure/table/reinforced,
/turf/open/floor/plasteel/dark,
/area/space)
"R" = (
/turf/open/floor/plasteel/stairs{
	dir = 8
	},
/area/space)
"T" = (
/obj/structure/railing{
	dir = 6
	},
/obj/structure/table/reinforced,
/obj/item/megaphone,
/turf/open/floor/plasteel/dark,
/area/space)
"X" = (
/obj/structure/railing{
	dir = 4
	},
/obj/structure/railing{
	dir = 10
	},
/turf/open/floor/plasteel/dark,
/area/space)

(1,1,1) = {"
a
a
a
a
a
a
a
a
a
a
a
a
a
a
a
a
a
a
a
a
a
a
a
a
a
a
a
a
a
a
a
a
a
a
a
a
a
a
a
a
a
a
a
a
a
"}
(2,1,1) = {"
a
a
a
a
a
a
a
a
a
a
a
a
a
a
a
a
a
a
a
a
a
a
a
a
a
a
a
a
a
a
a
a
a
a
a
a
a
a
a
a
a
a
a
a
a
"}
(3,1,1) = {"
a
a
a
a
a
a
a
a
a
a
a
a
a
a
a
a
a
a
a
a
a
a
a
a
a
a
a
a
a
a
a
a
a
a
a
a
a
a
a
a
a
a
a
a
a
"}
(4,1,1) = {"
a
a
a
a
a
a
a
a
a
a
a
a
a
a
a
a
a
a
a
a
a
a
a
a
a
a
a
a
a
a
C
C
C
C
C
a
a
a
a
a
a
a
a
a
a
"}
(5,1,1) = {"
a
a
a
a
a
a
a
a
a
a
a
a
a
a
a
a
a
a
a
a
a
a
a
a
a
a
a
a
a
a
i
i
i
z
C
a
a
a
a
a
a
a
a
a
a
"}
(6,1,1) = {"
a
a
a
a
a
a
a
a
a
a
a
a
a
a
a
a
a
a
a
a
a
a
a
a
a
a
a
a
a
a
K
K
k
z
C
a
a
a
a
a
a
a
a
a
a
"}
(7,1,1) = {"
a
a
a
a
a
a
a
a
a
a
a
a
a
a
a
a
a
a
a
a
a
a
a
a
a
a
a
a
a
a
x
x
c
z
C
a
a
a
a
a
a
a
a
a
a
"}
(8,1,1) = {"
a
a
a
a
a
a
a
a
a
a
a
a
a
a
a
a
a
a
a
a
a
a
a
a
a
a
a
a
a
a
z
z
z
z
C
a
a
a
a
a
a
a
a
a
a
"}
(9,1,1) = {"
a
a
a
a
a
a
a
a
a
a
a
a
a
a
a
a
a
a
a
a
a
a
a
a
a
a
a
a
a
a
z
E
z
C
C
a
a
a
a
a
a
a
a
a
a
"}
(10,1,1) = {"
a
a
a
a
a
a
a
a
a
a
a
a
a
a
a
a
a
a
a
a
a
a
a
a
a
a
a
a
a
a
P
P
P
C
a
a
a
a
a
a
a
a
a
a
a
"}
(11,1,1) = {"
a
a
a
a
a
a
a
a
a
a
a
a
a
a
a
a
a
a
a
a
a
a
a
a
a
a
a
a
a
a
a
a
a
a
a
a
a
a
a
a
a
a
a
a
a
"}
(12,1,1) = {"
a
a
a
a
a
a
a
a
a
a
a
a
a
a
a
a
a
a
a
a
a
a
a
a
a
a
a
a
a
a
a
a
a
a
a
a
a
a
a
a
a
a
a
a
a
"}
(13,1,1) = {"
a
a
a
a
a
a
a
a
a
a
a
a
a
a
a
a
a
a
a
a
a
a
a
a
a
a
a
a
a
a
a
a
a
a
a
a
a
a
a
a
a
a
a
a
a
"}
(14,1,1) = {"
a
a
a
a
a
a
a
a
a
a
a
a
a
a
a
a
a
a
a
a
a
a
a
a
a
a
a
a
a
a
a
a
a
a
a
a
a
a
a
a
a
a
a
a
a
"}
(15,1,1) = {"
a
a
a
a
a
a
a
a
a
a
a
a
a
a
a
a
a
a
a
a
a
a
a
a
a
a
a
a
a
a
a
a
a
a
a
a
a
a
a
a
a
a
a
a
a
"}
(16,1,1) = {"
a
a
a
a
a
a
a
a
a
a
a
a
a
a
a
a
a
a
a
a
a
a
a
a
a
a
a
a
a
a
a
a
a
a
a
a
a
a
a
a
a
a
a
a
a
"}
(17,1,1) = {"
a
a
a
a
a
a
a
a
a
a
a
a
a
a
a
a
a
a
a
a
a
a
a
a
a
a
a
a
a
a
a
a
a
a
a
a
a
a
a
a
a
a
a
a
a
"}
(18,1,1) = {"
a
a
a
a
a
a
a
a
a
a
a
a
C
z
z
z
z
z
z
C
a
a
a
a
a
a
a
a
a
C
z
z
z
z
z
z
C
a
a
a
a
a
a
a
a
"}
(19,1,1) = {"
a
a
a
a
a
a
a
a
a
a
a
a
C
z
z
z
z
z
z
C
a
a
a
a
a
a
a
a
a
C
z
z
z
z
z
z
C
a
a
a
a
a
a
a
a
"}
(20,1,1) = {"
a
a
a
a
a
a
a
a
a
a
a
a
C
z
z
z
z
z
z
C
a
a
a
a
a
a
a
a
a
C
z
z
z
z
z
z
C
a
a
a
a
a
a
a
a
"}
(21,1,1) = {"
a
a
a
a
a
a
a
a
a
a
a
a
C
z
z
z
z
z
z
C
a
a
a
a
a
a
a
a
a
C
z
z
z
z
z
z
C
a
a
a
a
a
a
a
a
"}
(22,1,1) = {"
a
a
a
a
a
a
a
a
a
a
a
a
C
C
C
C
C
A
A
C
a
a
a
a
a
a
a
a
a
C
A
A
C
C
C
C
C
a
a
a
a
a
a
a
a
"}
(23,1,1) = {"
a
a
a
a
a
a
a
a
a
a
a
a
C
z
z
z
z
z
z
C
a
a
a
a
a
a
a
a
a
C
z
N
z
z
z
z
C
a
a
a
a
a
a
a
a
"}
(24,1,1) = {"
a
a
a
a
a
a
a
a
a
a
a
a
C
z
z
z
z
z
z
C
a
a
a
a
a
a
a
a
a
C
z
N
z
z
z
z
C
a
a
a
a
a
a
a
a
"}
(25,1,1) = {"
a
a
a
a
a
a
a
a
a
a
a
a
C
z
z
z
z
z
z
C
a
a
a
a
a
a
a
a
a
C
z
N
z
z
z
z
C
a
a
a
a
a
a
a
a
"}
(26,1,1) = {"
a
a
a
a
a
a
a
a
a
a
a
C
C
C
C
C
C
N
t
C
C
C
e
e
e
e
e
C
C
C
z
N
C
C
C
C
C
C
a
a
a
a
a
a
a
"}
(27,1,1) = {"
a
a
a
a
a
a
a
a
a
a
a
C
N
N
N
N
C
N
t
C
C
p
p
p
p
p
p
p
C
C
t
N
N
N
N
N
N
C
a
a
a
a
a
a
a
"}
(28,1,1) = {"
a
a
a
a
a
a
a
a
a
a
a
C
N
N
N
N
C
N
t
G
p
p
p
p
p
p
p
p
p
G
t
N
N
N
N
N
N
C
a
a
a
a
a
a
a
"}
(29,1,1) = {"
a
a
a
a
a
a
a
a
a
a
a
C
N
N
N
N
C
N
t
G
p
p
M
M
M
M
M
p
p
G
t
N
N
N
N
N
N
C
a
a
a
a
a
a
a
"}
(30,1,1) = {"
a
a
a
a
a
a
a
a
a
a
a
C
N
N
N
N
C
N
t
G
p
q
M
M
M
M
M
q
p
G
t
N
N
N
N
N
N
C
a
a
a
a
a
a
a
"}
(31,1,1) = {"
a
a
a
a
a
a
a
a
a
a
a
C
N
N
N
N
C
N
t
G
p
d
M
M
M
M
M
d
p
G
t
N
N
N
N
N
N
C
a
a
a
a
a
a
a
"}
(32,1,1) = {"
a
a
a
a
a
a
a
a
a
a
a
C
N
N
N
N
C
N
t
G
p
d
M
M
M
M
M
d
p
G
t
N
N
N
N
N
N
C
a
a
a
a
a
a
a
"}
(33,1,1) = {"
a
a
a
a
a
a
a
a
a
a
a
C
N
N
N
N
C
N
t
G
p
d
M
M
M
M
M
d
p
G
t
N
N
N
N
N
N
C
a
a
a
a
a
a
a
"}
(34,1,1) = {"
a
a
a
a
a
a
a
a
a
a
a
C
N
N
N
N
C
N
t
G
p
d
M
M
M
M
M
d
p
G
t
N
N
N
N
N
N
C
a
a
a
a
a
a
a
"}
(35,1,1) = {"
a
a
a
a
a
a
a
a
a
a
a
C
N
N
N
N
C
N
t
G
p
d
M
M
M
M
M
d
p
G
t
N
N
N
N
N
N
C
a
a
a
a
a
a
a
"}
(36,1,1) = {"
a
a
a
a
a
a
a
a
a
a
a
C
N
N
N
N
C
N
t
G
p
R
M
M
M
M
M
R
p
G
t
N
N
N
N
N
N
C
a
a
a
a
a
a
a
"}
(37,1,1) = {"
a
a
a
a
a
a
a
a
a
a
a
C
N
N
N
N
C
N
t
G
p
p
M
M
M
M
M
p
p
G
t
N
N
N
N
N
N
C
a
a
a
a
a
a
a
"}
(38,1,1) = {"
a
a
a
a
a
a
a
a
a
a
a
C
N
N
N
N
C
N
t
G
p
p
p
p
p
p
p
p
p
G
t
N
N
N
N
N
N
C
a
a
a
a
a
a
a
"}
(39,1,1) = {"
a
a
a
a
a
a
a
a
a
a
a
C
N
N
N
N
C
N
t
C
C
p
p
p
p
p
p
p
C
C
t
N
N
N
N
N
N
C
a
a
a
a
a
a
a
"}
(40,1,1) = {"
a
a
a
a
a
a
a
a
a
a
a
C
C
C
C
C
C
F
r
C
C
C
L
L
L
L
L
C
C
C
t
N
C
C
C
C
C
C
a
a
a
a
a
a
a
"}
(41,1,1) = {"
a
a
a
a
a
a
a
a
a
a
a
a
C
N
N
C
N
N
t
C
a
a
a
a
a
a
a
a
a
C
t
N
N
N
N
N
C
a
a
a
a
a
a
a
a
"}
(42,1,1) = {"
a
a
a
a
a
a
a
a
a
a
a
a
C
N
N
C
N
N
t
C
a
a
a
a
a
a
a
a
a
C
t
t
t
t
N
N
C
a
a
a
a
a
a
a
a
"}
(43,1,1) = {"
a
a
a
a
a
a
a
a
a
a
a
a
C
C
N
C
N
N
N
C
a
a
a
a
a
a
a
a
a
C
C
C
C
N
C
C
C
a
a
a
a
a
a
a
a
"}
(44,1,1) = {"
a
a
a
a
a
a
a
a
a
a
a
a
C
N
N
N
N
N
N
C
a
a
a
a
a
a
a
a
a
C
Q
O
T
N
N
N
C
a
a
a
a
a
a
a
a
"}
(45,1,1) = {"
a
a
a
a
a
a
a
a
a
a
a
a
C
N
N
N
N
N
N
C
a
a
a
a
a
a
a
a
a
C
K
K
k
N
N
N
C
a
a
a
a
a
a
a
a
"}
(46,1,1) = {"
a
a
a
a
a
a
a
a
a
a
a
a
C
N
N
N
N
N
N
C
a
a
a
a
a
a
a
a
a
C
x
x
X
N
N
N
C
a
a
a
a
a
a
a
a
"}
(47,1,1) = {"
a
a
a
a
a
a
a
a
a
a
a
a
C
C
N
N
N
N
N
C
a
a
a
a
a
a
a
a
a
C
N
u
N
N
N
C
C
a
a
a
a
a
a
a
a
"}
(48,1,1) = {"
a
a
a
a
a
a
a
a
a
a
a
a
a
C
C
N
N
N
N
C
a
a
a
a
a
a
a
a
a
B
N
f
N
N
B
B
a
a
a
a
a
a
a
a
a
"}
(49,1,1) = {"
a
a
a
a
a
a
a
a
a
a
a
a
a
a
C
C
C
C
C
C
a
a
a
a
a
a
a
a
a
B
B
B
B
B
P
a
a
a
a
a
a
a
a
a
a
"}
(50,1,1) = {"
a
a
a
a
a
a
a
a
a
a
a
a
a
a
a
a
a
a
a
a
a
a
a
a
a
a
a
a
a
a
a
a
a
a
a
a
a
a
a
a
a
a
a
a
a
"}
(51,1,1) = {"
a
a
a
a
a
a
a
a
a
a
a
a
a
a
a
a
a
a
a
a
a
a
a
a
a
a
a
a
a
a
a
a
a
a
a
a
a
a
a
a
a
a
a
a
a
"}
(52,1,1) = {"
a
a
a
a
a
a
a
a
a
a
a
a
a
a
a
a
a
a
a
a
a
a
a
a
a
a
a
a
a
a
a
a
a
a
a
a
a
a
a
a
a
a
a
a
a
"}
(53,1,1) = {"
a
a
a
a
a
a
a
a
a
a
a
a
a
a
a
a
a
a
a
a
a
a
a
a
a
a
a
a
a
a
a
a
a
a
a
a
a
a
a
a
a
a
a
a
a
"}
(54,1,1) = {"
a
a
a
a
a
a
a
a
a
a
a
a
a
a
a
a
a
a
a
a
a
a
a
a
a
a
a
a
a
a
a
a
a
a
a
a
a
a
a
a
a
a
a
a
a
"}
(55,1,1) = {"
a
a
a
a
a
a
a
a
a
a
a
a
a
a
a
a
a
a
a
a
a
a
a
a
a
a
a
a
a
a
a
a
a
a
a
a
a
a
a
a
a
a
a
a
a
"}
(56,1,1) = {"
a
a
a
a
a
a
a
a
a
a
a
a
a
a
a
a
a
a
a
a
a
a
a
a
a
a
a
a
a
a
a
a
a
a
a
a
a
a
a
a
a
a
a
a
a
"}
(57,1,1) = {"
a
a
a
a
a
a
a
a
a
a
a
a
a
a
a
a
a
a
a
a
a
a
a
a
a
a
a
a
a
a
a
a
a
a
a
a
a
a
a
a
a
a
a
a
a
"}
(58,1,1) = {"
a
a
a
a
a
a
a
a
a
a
a
a
a
a
a
a
a
a
a
a
a
a
a
a
a
a
a
a
a
a
a
a
a
a
a
a
a
a
a
a
a
a
a
a
a
"}
(59,1,1) = {"
a
a
a
a
a
a
a
a
a
a
a
a
a
a
a
a
a
a
a
a
a
a
a
a
a
a
a
a
a
a
a
a
a
a
a
a
a
a
a
a
a
a
a
a
a
"}
(60,1,1) = {"
a
a
a
a
a
a
a
a
a
a
a
a
a
a
a
a
a
a
a
a
a
a
a
a
a
a
a
a
a
a
a
a
a
a
a
a
a
a
a
a
a
a
a
a
a
"}
(61,1,1) = {"
a
a
a
a
a
a
a
a
a
a
a
a
a
a
a
a
a
a
a
a
a
a
a
a
a
a
a
a
a
a
a
a
a
a
a
a
a
a
a
a
a
a
a
a
a
"}
(62,1,1) = {"
a
a
a
a
a
a
a
a
a
a
a
a
a
a
a
a
a
a
a
a
a
a
a
a
a
a
a
a
a
a
a
a
a
a
a
a
a
a
a
a
a
a
a
a
a
"}
(63,1,1) = {"
a
a
a
a
a
a
a
a
a
a
a
a
a
a
a
a
a
a
a
a
a
a
a
a
a
a
a
a
a
a
a
a
a
a
a
a
a
a
a
a
a
a
a
a
a
"}
(64,1,1) = {"
a
a
a
a
a
a
a
a
a
a
a
a
a
a
a
a
a
a
a
a
a
a
a
a
a
a
a
a
a
a
a
a
a
a
a
a
a
a
a
a
a
a
a
a
a
"}
(65,1,1) = {"
a
a
a
a
a
a
a
a
a
a
a
a
a
a
a
a
a
a
a
a
a
a
a
a
a
a
a
a
a
a
a
a
a
a
a
a
a
a
a
a
a
a
a
a
a
"}
(66,1,1) = {"
a
a
a
a
a
a
a
a
a
a
a
a
a
a
a
a
a
a
a
a
a
a
a
a
a
a
a
a
a
a
a
a
a
a
a
a
a
a
a
a
a
a
a
a
a
"}
(67,1,1) = {"
a
a
a
a
a
a
a
a
a
a
a
a
a
a
a
a
a
a
a
a
a
a
a
a
a
a
a
a
a
a
a
a
a
a
a
a
a
a
a
a
a
a
a
a
a
"}
(68,1,1) = {"
a
a
a
a
a
a
a
a
a
a
a
a
a
a
a
a
a
a
a
a
a
a
a
a
a
a
a
a
a
a
a
a
a
a
a
a
a
a
a
a
a
a
a
a
a
"}
(69,1,1) = {"
a
a
a
a
a
a
a
a
a
a
a
a
a
a
a
a
a
a
a
a
a
a
a
a
a
a
a
a
a
a
a
a
a
a
a
a
a
a
a
a
a
a
a
a
a
"}
(70,1,1) = {"
a
a
a
a
a
a
a
a
a
a
a
a
a
a
a
a
a
a
a
a
a
a
a
a
a
a
a
a
a
a
a
a
a
a
a
a
a
a
a
a
a
a
a
a
a
"}
