//MAP CONVERTED BY dmm2tgm.py THIS HEADER COMMENT PREVENTS RECONVERSION, DO NOT REMOVE
"a" = (
/turf/open/floor/plating/asteroid/wasteplanet/lit,
/area/space)
"c" = (
/obj/structure/railing{
	dir = 8
	},
/obj/structure/railing{
	dir = 6
	},
/turf/open/floor/plasteel/dark,
/area/space)
"e" = (
/turf/open/floor/plasteel/stairs{
	dir = 8
	},
/area/space)
"f" = (
/obj/machinery/door/airlock/atmos{
	dir = 4
	},
/turf/open/floor/plating,
/area/space)
"j" = (
/turf/open/floor/plasteel/mono{
	dir = 1
	},
/area/space)
"k" = (
/obj/structure/stairs/north,
/turf/open/floor/plasteel/dark,
/area/space)
"m" = (
/turf/open/floor/plasteel/mono,
/area/space)
"q" = (
/obj/machinery/door/airlock/freezer{
	dir = 4
	},
/turf/open/floor/hangar/plasteel/white,
/area/space)
"u" = (
/turf/open/floor/plasteel/stairs{
	dir = 4
	},
/area/space)
"x" = (
/obj/structure/railing{
	dir = 4
	},
/turf/open/floor/plasteel/dark,
/area/space)
"z" = (
/turf/open/floor/plating,
/area/space)
"A" = (
/obj/machinery/door/airlock/engineering{
	dir = 4
	},
/turf/open/floor/plating,
/area/space)
"B" = (
/turf/open/floor/pod,
/area/space)
"C" = (
/turf/closed/wall/r_wall,
/area/space)
"D" = (
/obj/machinery/door/airlock/hatch,
/turf/open/floor/hangar/plasteel,
/area/space)
"E" = (
/obj/machinery/computer/helm{
	dir = 8
	},
/turf/open/floor/plating,
/area/space)
"G" = (
/obj/machinery/door/airlock/mining{
	dir = 4
	},
/turf/open/floor/plating,
/area/space)
"I" = (
/turf/open/floor/plasteel/grimy,
/area/space)
"K" = (
/turf/open/floor/plasteel/dark,
/area/space)
"L" = (
/obj/machinery/door/poddoor/shutters{
	dir = 4
	},
/turf/open/floor/plating,
/area/space)
"M" = (
/turf/open/floor/hangar/plasteel/white,
/area/space)
"N" = (
/turf/open/floor/hangar/plasteel,
/area/space)
"O" = (
/obj/structure/chair/comfy/beige/directional/east,
/turf/open/floor/plasteel/dark,
/area/space)
"P" = (
/obj/structure/window/reinforced/fulltile,
/obj/structure/grille,
/turf/open/floor/plating,
/area/space)
"Q" = (
/turf/open/space/basic,
/area/space)
"T" = (
/obj/structure/railing{
	dir = 6
	},
/obj/structure/table/reinforced,
/obj/item/megaphone,
/turf/open/floor/plasteel/dark,
/area/space)
"W" = (
/obj/structure/table/reinforced,
/obj/machinery/computer/secure_data/laptop,
/turf/open/floor/plasteel/dark,
/area/space)
"Z" = (
/obj/machinery/door/poddoor/shutters,
/turf/open/floor/plating,
/area/space)

(1,1,1) = {"
a
a
a
a
a
a
a
a
a
a
a
a
a
a
a
a
a
a
a
a
a
a
a
a
a
a
a
a
a
a
a
a
a
a
a
a
a
a
a
a
a
a
a
a
a
"}
(2,1,1) = {"
a
a
a
a
a
a
a
a
a
a
a
a
a
a
a
a
a
a
a
a
a
a
a
a
a
a
a
a
a
a
a
a
a
a
a
a
a
a
a
a
a
a
a
a
a
"}
(3,1,1) = {"
a
a
a
a
a
a
a
a
a
a
a
a
a
a
a
a
a
a
a
a
a
a
a
a
a
a
a
a
a
a
a
a
a
a
a
a
a
a
a
a
a
a
a
a
a
"}
(4,1,1) = {"
a
a
a
a
a
a
a
a
a
a
a
a
a
a
a
a
a
a
a
a
a
a
a
a
a
a
a
a
a
a
a
a
a
a
a
a
a
a
a
a
a
a
a
a
a
"}
(5,1,1) = {"
a
a
a
a
a
a
a
a
a
a
a
a
a
a
a
a
a
a
a
a
a
a
a
a
a
a
a
a
a
a
a
a
a
a
a
a
a
a
a
a
a
a
a
a
a
"}
(6,1,1) = {"
a
a
a
a
a
a
a
a
a
a
a
a
a
a
a
a
a
a
a
a
a
a
a
a
a
a
a
a
a
a
a
a
a
a
a
a
a
a
a
a
a
a
a
a
a
"}
(7,1,1) = {"
a
a
a
a
a
a
a
a
a
a
a
a
a
a
a
a
a
a
a
a
a
a
a
a
a
a
a
a
a
a
a
a
a
a
a
a
a
a
a
a
a
a
a
a
a
"}
(8,1,1) = {"
a
a
a
a
a
a
a
a
a
a
a
a
a
a
a
a
a
a
a
a
a
a
a
a
a
a
a
a
a
a
a
a
a
a
a
a
a
a
a
a
a
a
a
a
a
"}
(9,1,1) = {"
a
a
a
a
a
a
a
a
a
a
a
a
a
a
a
a
a
a
a
a
a
a
a
a
a
a
a
a
a
a
a
a
a
a
a
a
a
a
a
a
a
a
a
a
a
"}
(10,1,1) = {"
a
a
a
a
a
a
a
a
a
a
a
a
a
a
a
a
a
a
a
a
a
a
a
a
a
a
a
a
a
a
a
a
a
a
a
a
a
a
a
a
a
a
a
a
a
"}
(11,1,1) = {"
a
a
a
a
a
a
a
a
a
a
a
a
a
a
a
a
a
a
a
a
a
a
a
a
a
a
a
a
a
a
a
a
a
a
a
a
a
a
a
a
a
a
a
a
a
"}
(12,1,1) = {"
a
a
a
a
a
a
a
a
a
a
a
a
a
a
a
a
a
a
a
a
a
a
a
a
a
a
a
a
a
a
a
a
a
a
a
a
a
a
a
a
a
a
a
a
a
"}
(13,1,1) = {"
a
a
a
a
a
a
a
a
a
a
a
a
a
a
a
a
a
a
a
a
a
a
a
a
a
a
a
a
a
a
a
a
a
a
a
a
a
a
a
a
a
a
a
a
a
"}
(14,1,1) = {"
a
a
a
a
a
a
a
a
a
a
a
a
a
a
a
a
a
a
a
a
a
a
a
a
a
a
a
a
a
a
a
a
a
a
a
a
a
a
a
a
a
a
a
a
a
"}
(15,1,1) = {"
a
a
a
a
a
a
a
a
a
a
a
a
a
a
a
a
a
a
a
a
a
a
a
a
a
a
a
a
a
a
a
a
a
a
a
a
a
a
a
a
a
a
a
a
a
"}
(16,1,1) = {"
a
a
a
a
a
a
a
a
a
a
a
a
a
a
a
a
a
a
a
a
a
a
a
a
a
a
a
a
a
a
a
a
a
a
a
a
a
a
a
a
a
a
a
a
a
"}
(17,1,1) = {"
a
a
a
a
a
a
a
a
a
a
a
a
a
a
a
a
a
a
a
a
a
a
a
a
a
a
a
a
a
a
a
a
a
a
a
a
a
a
a
a
a
a
a
a
a
"}
(18,1,1) = {"
a
a
a
a
a
a
a
C
z
z
z
z
z
C
a
a
a
a
a
a
a
a
a
a
a
a
a
a
a
a
a
a
a
a
a
a
a
a
a
a
a
a
a
a
a
"}
(19,1,1) = {"
a
a
a
a
a
a
a
C
z
z
z
z
z
C
Q
Q
Q
Q
Q
Q
Q
a
a
a
a
a
a
a
a
a
a
a
a
a
a
a
a
a
a
a
a
a
a
a
a
"}
(20,1,1) = {"
a
a
a
a
a
a
a
C
z
z
z
z
z
C
Q
Q
Q
Q
Q
Q
Q
a
a
a
a
a
a
a
a
a
a
a
a
a
a
a
a
a
a
a
a
a
a
a
a
"}
(21,1,1) = {"
a
a
a
a
a
a
a
C
z
z
z
z
z
C
Q
Q
Q
Q
Q
Q
Q
a
a
a
a
a
a
a
Q
Q
Q
Q
Q
Q
Q
Q
Q
Q
Q
Q
a
a
a
a
a
"}
(22,1,1) = {"
a
a
a
a
a
a
a
C
z
z
z
z
z
C
Q
Q
Q
Q
Q
Q
Q
a
a
a
a
a
a
a
Q
Q
Q
C
z
z
z
z
z
C
a
a
a
a
a
a
a
"}
(23,1,1) = {"
a
a
a
a
a
a
a
C
z
z
z
z
z
C
Q
Q
Q
Q
Q
Q
Q
a
a
a
a
a
a
a
Q
Q
Q
C
z
z
z
z
z
C
a
a
a
a
a
a
a
"}
(24,1,1) = {"
a
a
a
a
a
a
C
C
C
z
z
z
z
C
Q
Q
Q
Q
Q
Q
Q
m
z
z
z
z
z
m
Q
Q
Q
C
z
z
z
z
z
C
a
a
a
a
a
a
a
"}
(25,1,1) = {"
a
a
a
a
a
C
C
I
C
C
C
A
A
C
Q
Q
Q
Q
Q
Q
Q
m
m
m
m
m
m
m
Q
Q
Q
C
z
z
z
z
z
C
a
a
a
a
a
a
a
"}
(26,1,1) = {"
a
a
a
a
a
C
I
I
I
I
D
N
N
C
Q
Q
Q
Q
Q
Q
m
m
m
m
m
m
m
m
m
Q
Q
C
z
z
z
z
z
C
a
a
a
a
a
a
a
"}
(27,1,1) = {"
a
a
a
a
a
C
I
I
I
I
D
N
N
C
Q
Q
Q
Q
Q
Q
m
m
B
B
B
B
B
m
m
Q
Q
C
z
z
z
z
z
C
a
a
a
a
a
a
a
"}
(28,1,1) = {"
a
a
a
a
a
C
I
I
I
I
C
N
N
C
Q
Q
Q
Q
Q
Q
m
u
B
B
B
B
B
u
m
Q
Q
C
z
z
z
z
z
C
a
a
a
a
a
a
a
"}
(29,1,1) = {"
a
a
a
a
a
C
I
I
I
I
C
N
N
C
Q
Q
Q
Q
Q
Q
m
z
B
B
B
B
B
z
m
Q
Q
C
C
C
C
f
f
C
a
a
a
a
a
a
a
"}
(30,1,1) = {"
a
a
a
a
a
C
I
I
I
I
C
N
N
C
Q
Q
Q
Q
Q
Q
m
z
B
B
B
B
B
z
m
Q
Q
C
N
N
N
N
N
C
C
C
C
C
C
a
a
"}
(31,1,1) = {"
a
a
a
a
a
C
I
I
I
I
C
N
N
C
Q
Q
Q
Q
Q
Q
m
z
B
B
B
B
B
z
m
Q
Q
C
N
N
N
N
N
P
W
O
T
z
C
a
a
"}
(32,1,1) = {"
a
a
a
a
a
C
C
C
C
C
C
G
G
C
Q
Q
Q
Q
Q
Q
m
z
B
B
B
B
B
z
m
Q
Q
C
C
q
C
N
N
z
K
K
k
z
C
a
a
"}
(33,1,1) = {"
a
a
a
a
a
C
N
N
N
N
N
N
N
C
Q
Q
Q
Q
Q
Q
m
z
B
B
B
B
B
z
m
Q
Q
C
M
M
C
N
N
P
x
x
c
z
C
a
a
"}
(34,1,1) = {"
a
a
a
a
a
C
N
N
N
N
N
N
N
C
Q
Q
Q
Q
Q
Q
m
e
B
B
B
B
B
e
m
Q
Q
C
M
M
C
N
N
C
z
z
z
z
C
a
a
"}
(35,1,1) = {"
a
a
a
a
a
C
N
N
N
N
N
N
N
C
Q
Q
Q
Q
Q
Q
m
m
B
B
B
B
B
m
m
Q
Q
C
M
M
C
N
N
C
z
E
z
C
C
a
a
"}
(36,1,1) = {"
a
a
a
a
a
C
N
N
N
N
N
N
N
C
Q
Q
Q
Q
Q
Q
m
m
m
m
m
m
m
m
m
Q
Q
C
C
C
C
G
G
C
P
P
P
C
a
a
a
"}
(37,1,1) = {"
a
a
a
a
a
C
N
N
N
N
N
N
N
C
Q
Q
Q
Q
Q
Q
Q
m
m
m
m
m
m
m
Q
Q
Q
C
N
N
N
N
N
C
a
a
a
a
a
a
a
"}
(38,1,1) = {"
a
a
a
a
a
C
N
N
N
N
N
N
j
Z
Q
Q
Q
Q
Q
Q
Q
m
z
z
z
z
z
m
Q
Q
Q
C
N
N
N
N
N
C
a
a
a
a
a
a
a
"}
(39,1,1) = {"
a
a
a
a
a
C
N
N
N
N
N
N
j
Z
Q
Q
Q
Q
Q
Q
Q
a
a
a
a
a
a
a
Q
Q
Q
C
N
N
N
N
N
C
a
a
a
a
a
a
a
"}
(40,1,1) = {"
a
a
a
a
a
C
N
N
N
N
N
N
j
Z
Q
Q
Q
Q
Q
Q
Q
a
a
a
a
a
a
a
Q
Q
Q
C
N
N
N
N
N
C
a
a
a
a
a
a
a
"}
(41,1,1) = {"
a
a
a
a
a
C
N
N
N
N
N
N
j
Z
Q
Q
Q
Q
Q
Q
Q
a
a
a
a
a
a
a
Q
Q
Q
C
N
N
N
N
N
C
a
a
a
a
a
a
a
"}
(42,1,1) = {"
a
a
a
a
a
C
N
N
N
N
N
N
j
Z
Q
Q
Q
Q
Q
Q
Q
a
a
a
a
a
a
a
Q
Q
Q
C
N
N
N
N
N
C
a
a
a
a
a
a
a
"}
(43,1,1) = {"
a
a
a
a
a
C
C
N
N
N
N
N
N
C
Q
Q
Q
Q
Q
Q
Q
a
a
a
a
a
a
a
Q
Q
Q
C
N
N
N
N
N
C
a
a
a
a
a
a
a
"}
(44,1,1) = {"
a
a
a
a
a
a
C
N
N
N
N
N
N
C
Q
Q
Q
Q
Q
Q
Q
a
a
a
a
a
a
a
Q
Q
Q
C
N
N
N
N
N
C
a
a
a
a
a
a
a
"}
(45,1,1) = {"
a
a
a
a
a
a
C
C
N
N
N
N
N
C
Q
Q
Q
Q
Q
Q
Q
a
a
a
a
a
a
a
Q
Q
Q
C
N
N
N
N
N
C
a
a
a
a
a
a
a
"}
(46,1,1) = {"
a
a
a
a
a
a
a
C
C
N
N
N
N
C
Q
Q
Q
Q
Q
Q
Q
a
a
a
a
a
a
a
Q
Q
Q
C
N
N
N
N
N
C
a
a
a
a
a
a
a
"}
(47,1,1) = {"
a
a
a
a
a
a
a
a
C
C
N
N
N
C
Q
Q
Q
Q
Q
Q
Q
a
a
a
a
a
a
a
Q
Q
Q
C
N
N
N
N
N
C
a
a
a
a
a
a
a
"}
(48,1,1) = {"
a
a
a
a
a
a
a
a
a
C
C
N
N
C
Q
Q
Q
Q
Q
Q
Q
a
a
a
a
a
a
a
Q
Q
Q
C
N
N
N
N
N
C
a
a
a
a
a
a
a
"}
(49,1,1) = {"
a
a
a
a
a
a
a
a
a
a
C
C
C
C
Q
Q
Q
Q
Q
Q
Q
a
a
a
a
a
a
a
Q
Q
Q
C
j
j
j
N
N
C
a
a
a
a
a
a
a
"}
(50,1,1) = {"
a
a
a
a
a
a
a
a
a
a
a
a
a
a
Q
Q
Q
Q
Q
Q
Q
a
a
a
a
a
a
a
Q
Q
Q
C
L
L
L
C
C
C
a
a
a
a
a
a
a
"}
(51,1,1) = {"
a
a
a
a
a
a
a
a
a
a
a
a
a
a
Q
Q
Q
Q
Q
Q
Q
a
a
a
a
a
a
a
a
a
a
a
a
a
a
a
a
a
a
a
a
a
a
a
a
"}
(52,1,1) = {"
a
a
a
a
a
a
a
a
a
a
a
Q
Q
Q
Q
Q
Q
Q
Q
Q
Q
a
a
a
a
a
a
a
a
a
a
a
a
a
a
a
a
a
a
a
a
a
a
a
a
"}
(53,1,1) = {"
a
a
a
a
a
a
a
a
a
a
a
Q
Q
Q
Q
Q
Q
Q
Q
Q
Q
a
a
a
a
a
a
a
a
a
a
a
a
a
a
a
a
a
a
a
a
a
a
a
a
"}
(54,1,1) = {"
a
a
a
a
a
a
a
a
a
a
a
a
a
a
a
a
a
a
a
a
a
a
a
a
a
a
a
a
a
a
a
a
a
a
a
a
a
a
a
a
a
a
a
a
a
"}
(55,1,1) = {"
a
a
a
a
a
a
a
a
a
a
a
a
a
a
a
a
a
a
a
a
a
a
a
a
a
a
a
a
a
a
a
a
a
a
a
a
a
a
a
a
a
a
a
a
a
"}
(56,1,1) = {"
a
a
a
a
a
a
a
a
a
a
a
a
a
a
a
a
a
a
a
a
a
a
a
a
a
a
a
a
a
a
a
a
a
a
a
a
a
a
a
a
a
a
a
a
a
"}
(57,1,1) = {"
a
a
a
a
a
a
a
a
a
a
a
a
a
a
a
a
a
a
a
a
a
a
a
a
a
a
a
a
a
a
a
a
a
a
a
a
a
a
a
a
a
a
a
a
a
"}
(58,1,1) = {"
a
a
a
a
a
a
a
a
a
a
a
a
a
a
a
a
a
a
a
a
a
a
a
a
a
a
a
a
a
a
a
a
a
a
a
a
a
a
a
a
a
a
a
a
a
"}
(59,1,1) = {"
a
a
a
a
a
a
a
a
a
a
a
a
a
a
a
a
a
a
a
a
a
a
a
a
a
a
a
a
a
a
a
a
a
a
a
a
a
a
a
a
a
a
a
a
a
"}
(60,1,1) = {"
a
a
a
a
a
a
a
a
a
a
a
a
a
a
a
a
a
a
a
a
a
a
a
a
a
a
a
a
a
a
a
a
a
a
a
a
a
a
a
a
a
a
a
a
a
"}
(61,1,1) = {"
a
a
a
a
a
a
a
a
a
a
a
a
a
a
a
a
a
a
a
a
a
a
a
a
a
a
a
a
a
a
a
a
a
a
a
a
a
a
a
a
a
a
a
a
a
"}
(62,1,1) = {"
a
a
a
a
a
a
a
a
a
a
a
a
a
a
a
a
a
a
a
a
a
a
a
a
a
a
a
a
a
a
a
a
a
a
a
a
a
a
a
a
a
a
a
a
a
"}
(63,1,1) = {"
a
a
a
a
a
a
a
a
a
a
a
a
a
a
a
a
a
a
a
a
a
a
a
a
a
a
a
a
a
a
a
a
a
a
a
a
a
a
a
a
a
a
a
a
a
"}
(64,1,1) = {"
a
a
a
a
a
a
a
a
a
a
a
a
a
a
a
a
a
a
a
a
a
a
a
a
a
a
a
a
a
a
a
a
a
a
a
a
a
a
a
a
a
a
a
a
a
"}
(65,1,1) = {"
a
a
a
a
a
a
a
a
a
a
a
a
a
a
a
a
a
a
a
a
a
a
a
a
a
a
a
a
a
a
a
a
a
a
a
a
a
a
a
a
a
a
a
a
a
"}
(66,1,1) = {"
a
a
a
a
a
a
a
a
a
a
a
a
a
a
a
a
a
a
a
a
a
a
a
a
a
a
a
a
a
a
a
a
a
a
a
a
a
a
a
a
a
a
a
a
a
"}
(67,1,1) = {"
a
a
a
a
a
a
a
a
a
a
a
a
a
a
a
a
a
a
a
a
a
a
a
a
a
a
a
a
a
a
a
a
a
a
a
a
a
a
a
a
a
a
a
a
a
"}
(68,1,1) = {"
a
a
a
a
a
a
a
a
a
a
a
a
a
a
a
a
a
a
a
a
a
a
a
a
a
a
a
a
a
a
a
a
a
a
a
a
a
a
a
a
a
a
a
a
a
"}
(69,1,1) = {"
a
a
a
a
a
a
a
a
a
a
a
a
a
a
a
a
a
a
a
a
a
a
a
a
a
a
a
a
a
a
a
a
a
a
a
a
a
a
a
a
a
a
a
a
a
"}
(70,1,1) = {"
a
a
a
a
a
a
a
a
a
a
a
a
a
a
a
a
a
a
a
a
a
a
a
a
a
a
a
a
a
a
a
a
a
a
a
a
a
a
a
a
a
a
a
a
a
"}
