//MAP CONVERTED BY dmm2tgm.py THIS HEADER COMMENT PREVENTS RECONVERSION, DO NOT REMOVE
"aE" = (
/obj/structure/railing{
	dir = 1
	},
/turf/open/floor/plasteel/stairs{
	dir = 8
	},
/area/space)
"bc" = (
/obj/effect/turf_decal/industrial/warning{
	dir = 6
	},
/turf/open/floor/concrete,
/area/space)
"fQ" = (
/turf/open/floor/concrete/reinforced,
/area/space)
"gB" = (
/turf/closed/wall/r_wall/syndicate,
/area/space)
"gX" = (
/obj/machinery/door/airlock/grunge{
	dir = 4
	},
/turf/open/space/basic,
/area/space)
"hu" = (
/obj/machinery/porta_turret/ship/ballistic,
/turf/closed/wall/mineral/plastitanium,
/area/space)
"ij" = (
/obj/structure/railing{
	dir = 8
	},
/turf/open/floor/plasteel/stairs,
/area/space)
"io" = (
/obj/structure/railing{
	dir = 4
	},
/turf/open/floor/plasteel/stairs{
	dir = 1
	},
/area/space)
"iE" = (
/obj/machinery/door/airlock/centcom{
	aiControlDisabled = 1;
	name = "Assault Pod";
	req_access_txt = "150";
	dir = 4
	},
/turf/open/floor/plating,
/area/space)
"kG" = (
/obj/structure/railing,
/turf/open/floor/concrete/slab_1,
/area/space)
"mh" = (
/turf/open/floor/plating,
/area/space)
"nv" = (
/obj/structure/railing/corner,
/turf/open/floor/concrete/slab_1,
/area/space)
"nx" = (
/obj/structure/bed/double/maint,
/turf/open/floor/mineral/plastitanium/red,
/area/space)
"nJ" = (
/turf/closed/mineral/random/whitesands,
/area/space)
"nS" = (
/obj/effect/turf_decal/industrial/stand_clear/white,
/turf/open/floor/concrete,
/area/space)
"pu" = (
/obj/structure/railing{
	dir = 8
	},
/turf/open/floor/mineral/plastitanium,
/area/space)
"pI" = (
/obj/structure/poddoor_assembly/shutters,
/turf/open/floor/mineral/plastitanium/red,
/area/space)
"qk" = (
/obj/structure/railing{
	dir = 4
	},
/turf/open/floor/plasteel/stairs,
/area/space)
"rs" = (
/obj/structure/railing{
	dir = 8
	},
/turf/open/floor/plasteel/stairs{
	dir = 1
	},
/area/space)
"si" = (
/obj/effect/turf_decal/industrial/stand_clear/white{
	dir = 1
	},
/turf/open/floor/concrete,
/area/space)
"tt" = (
/obj/structure/railing{
	dir = 6
	},
/obj/structure/table/reinforced,
/obj/item/documents/syndicate/red,
/turf/open/floor/mineral/plastitanium,
/area/space)
"tY" = (
/obj/structure/railing,
/turf/open/floor/plasteel/stairs{
	dir = 8
	},
/area/space)
"uh" = (
/obj/structure/chair/plastic{
	dir = 1
	},
/turf/open/floor/plasteel/dark,
/area/space)
"uj" = (
/obj/structure/chair/comfy/beige/directional/north,
/turf/open/floor/plasteel/dark,
/area/space)
"vh" = (
/obj/effect/turf_decal/industrial/warning{
	dir = 9
	},
/turf/open/floor/concrete,
/area/space)
"wo" = (
/turf/closed/wall/mineral/plastitanium,
/area/space)
"wV" = (
/obj/machinery/computer/helm/viewscreen/directional/north{
	name = "briefing monitor";
	desc = "A viewscreen for projecting visual aids during tactical briefings.."
	},
/turf/open/floor/plasteel/dark,
/area/space)
"yO" = (
/obj/machinery/door/airlock/grunge,
/turf/open/floor/plasteel/dark,
/area/space)
"zC" = (
/turf/open/floor/plasteel/dark,
/area/space)
"AO" = (
/turf/open/floor/plating/asteroid/whitesands/lit,
/area/space)
"Bc" = (
/obj/machinery/door/airlock/grunge{
	dir = 4
	},
/turf/open/floor/plasteel/dark,
/area/space)
"Dd" = (
/turf/open/floor/plasteel/stairs,
/area/space)
"Dg" = (
/obj/structure/table,
/turf/open/floor/plating,
/area/space)
"Dv" = (
/obj/effect/turf_decal/industrial/warning{
	dir = 10
	},
/turf/open/floor/concrete,
/area/space)
"Eh" = (
/obj/structure/railing/corner{
	dir = 8
	},
/turf/open/floor/concrete/slab_1,
/area/space)
"Fu" = (
/turf/open/floor/mineral/plastitanium/red,
/area/space)
"GA" = (
/obj/structure/railing{
	dir = 10
	},
/obj/structure/table/reinforced,
/obj/item/megaphone/command,
/turf/open/floor/mineral/plastitanium,
/area/space)
"Jw" = (
/obj/machinery/door/airlock/centcom{
	aiControlDisabled = 1;
	name = "Assault Pod";
	req_access_txt = "150";
	dir = 4
	},
/turf/open/floor/plating/asteroid/whitesands/lit,
/area/space)
"Kk" = (
/obj/machinery/door/poddoor/shutters,
/turf/open/floor/mineral/plastitanium/red,
/area/space)
"Lj" = (
/obj/machinery/shuttle_manipulator,
/turf/open/floor/plasteel/dark,
/area/space)
"LQ" = (
/obj/structure/chair/comfy/beige/directional/south,
/turf/open/floor/plasteel/dark,
/area/space)
"Mw" = (
/obj/effect/turf_decal/industrial/warning{
	dir = 5
	},
/turf/open/floor/concrete,
/area/space)
"Nx" = (
/obj/machinery/door/poddoor/shutters,
/turf/open/floor/plating,
/area/space)
"NV" = (
/obj/machinery/door/airlock/centcom{
	name = "Assault Pod";
	req_access_txt = "150"
	},
/turf/open/floor/plating,
/area/space)
"Ow" = (
/turf/open/floor/plasteel/stairs{
	dir = 8
	},
/area/space)
"OS" = (
/obj/structure/railing{
	dir = 4
	},
/turf/open/floor/concrete/slab_1,
/area/space)
"PJ" = (
/obj/effect/turf_decal/industrial/stand_clear/white{
	dir = 4
	},
/turf/open/floor/concrete,
/area/space)
"Qg" = (
/turf/open/floor/concrete,
/area/space)
"QT" = (
/obj/structure/railing/corner{
	dir = 4
	},
/turf/open/floor/concrete/slab_1,
/area/space)
"QZ" = (
/turf/open/space/basic,
/area/space)
"Re" = (
/obj/structure/railing/corner{
	dir = 4
	},
/turf/closed/mineral/random/whitesands,
/area/space)
"Rr" = (
/obj/machinery/door/airlock/centcom{
	name = "Assault Pod";
	req_access_txt = "150"
	},
/turf/open/floor/plating/asteroid/whitesands/lit,
/area/space)
"Tv" = (
/obj/structure/railing{
	dir = 4
	},
/turf/open/floor/mineral/plastitanium,
/area/space)
"Va" = (
/obj/structure/table/reinforced,
/turf/open/floor/plasteel/dark,
/area/space)
"Vc" = (
/turf/open/floor/concrete/slab_1,
/area/space)
"Wx" = (
/obj/structure/railing{
	dir = 8
	},
/turf/open/floor/concrete/slab_1,
/area/space)
"Xd" = (
/obj/structure/railing/corner{
	dir = 1
	},
/turf/open/floor/concrete/slab_1,
/area/space)
"Yh" = (
/obj/structure/railing{
	dir = 1
	},
/turf/open/floor/concrete/slab_1,
/area/space)

(1,1,1) = {"
QZ
QZ
QZ
QZ
QZ
QZ
QZ
QZ
QZ
QZ
QZ
QZ
QZ
QZ
QZ
QZ
QZ
QZ
QZ
QZ
QZ
QZ
QZ
QZ
QZ
AO
AO
AO
AO
AO
AO
AO
AO
AO
AO
AO
AO
AO
AO
AO
AO
AO
AO
AO
AO
AO
AO
AO
AO
AO
AO
AO
AO
AO
AO
AO
AO
AO
AO
AO
AO
AO
AO
AO
AO
AO
AO
AO
AO
AO
AO
AO
AO
AO
AO
"}
(2,1,1) = {"
QZ
QZ
QZ
QZ
QZ
QZ
QZ
QZ
QZ
QZ
QZ
QZ
QZ
QZ
QZ
QZ
QZ
QZ
QZ
QZ
QZ
QZ
QZ
QZ
QZ
AO
AO
AO
AO
AO
AO
AO
AO
AO
AO
AO
AO
AO
AO
AO
AO
AO
AO
AO
AO
AO
AO
AO
AO
AO
AO
AO
AO
AO
AO
AO
AO
AO
AO
AO
AO
AO
AO
AO
AO
AO
AO
AO
AO
AO
AO
AO
AO
AO
AO
"}
(3,1,1) = {"
QZ
QZ
QZ
QZ
QZ
QZ
QZ
QZ
QZ
QZ
QZ
QZ
QZ
QZ
QZ
QZ
QZ
QZ
QZ
QZ
QZ
QZ
QZ
QZ
QZ
AO
nJ
wo
wo
iE
wo
wo
nJ
AO
AO
AO
AO
AO
AO
AO
AO
AO
AO
AO
AO
AO
AO
AO
AO
AO
AO
AO
AO
AO
AO
AO
AO
AO
AO
AO
AO
AO
AO
AO
AO
AO
AO
AO
AO
AO
AO
AO
AO
AO
AO
"}
(4,1,1) = {"
QZ
QZ
QZ
QZ
QZ
QZ
QZ
QZ
QZ
QZ
QZ
QZ
QZ
QZ
QZ
QZ
QZ
QZ
QZ
QZ
QZ
QZ
QZ
QZ
QZ
AO
wo
wo
Fu
Fu
Fu
wo
wo
AO
AO
AO
AO
AO
AO
AO
AO
AO
AO
AO
AO
AO
AO
AO
AO
nJ
nJ
nJ
nJ
nJ
AO
AO
AO
AO
AO
AO
AO
AO
AO
AO
AO
AO
AO
AO
AO
AO
AO
AO
AO
AO
AO
"}
(5,1,1) = {"
QZ
QZ
QZ
QZ
QZ
QZ
QZ
QZ
QZ
QZ
QZ
QZ
QZ
QZ
QZ
QZ
QZ
QZ
QZ
QZ
QZ
QZ
QZ
QZ
QZ
AO
wo
Fu
Fu
Fu
Fu
Fu
wo
AO
AO
AO
AO
AO
AO
AO
AO
AO
AO
AO
AO
AO
AO
AO
AO
nJ
nJ
nJ
nJ
AO
AO
AO
AO
AO
AO
AO
AO
AO
AO
AO
AO
AO
AO
AO
AO
AO
AO
AO
AO
AO
AO
"}
(6,1,1) = {"
QZ
QZ
QZ
QZ
QZ
QZ
QZ
QZ
QZ
QZ
QZ
QZ
QZ
QZ
QZ
QZ
QZ
QZ
QZ
QZ
QZ
QZ
QZ
QZ
QZ
AO
NV
Fu
Fu
wo
Fu
Fu
NV
AO
AO
AO
AO
AO
AO
AO
AO
AO
AO
AO
AO
AO
AO
AO
nJ
nJ
nJ
nJ
nJ
fQ
fQ
fQ
fQ
fQ
fQ
fQ
fQ
fQ
fQ
fQ
fQ
fQ
fQ
fQ
fQ
fQ
fQ
fQ
fQ
fQ
AO
"}
(7,1,1) = {"
QZ
QZ
QZ
QZ
QZ
QZ
QZ
QZ
QZ
QZ
QZ
QZ
QZ
QZ
QZ
QZ
QZ
QZ
QZ
QZ
QZ
QZ
QZ
QZ
QZ
AO
wo
nx
Fu
Fu
Fu
Fu
wo
AO
AO
AO
AO
AO
AO
AO
AO
AO
AO
AO
AO
AO
AO
AO
nJ
nJ
nJ
nJ
nJ
fQ
Qg
Qg
Qg
Qg
Qg
Qg
Qg
Qg
Qg
Qg
Qg
Qg
Qg
Qg
Qg
Qg
Qg
Qg
Qg
fQ
AO
"}
(8,1,1) = {"
QZ
QZ
QZ
QZ
QZ
QZ
QZ
QZ
QZ
QZ
QZ
QZ
QZ
QZ
QZ
QZ
QZ
QZ
QZ
QZ
QZ
QZ
QZ
QZ
QZ
AO
hu
wo
Fu
Fu
Fu
wo
hu
AO
AO
AO
AO
AO
AO
AO
AO
nJ
nJ
nJ
nJ
nJ
nJ
nJ
nJ
nJ
nJ
nJ
nJ
fQ
Qg
vh
Qg
Qg
Qg
Qg
Qg
Qg
Qg
Qg
Qg
Qg
Qg
Qg
Qg
Qg
Qg
Dv
Qg
fQ
AO
"}
(9,1,1) = {"
QZ
QZ
QZ
QZ
QZ
QZ
QZ
QZ
QZ
QZ
QZ
QZ
QZ
QZ
QZ
QZ
QZ
QZ
QZ
QZ
QZ
QZ
QZ
QZ
QZ
AO
AO
hu
wo
iE
wo
hu
AO
AO
AO
AO
nJ
nJ
nJ
nJ
nJ
nJ
nJ
nJ
nJ
nJ
nJ
nJ
nJ
nJ
nJ
nJ
nJ
fQ
Qg
Qg
Qg
Qg
Qg
Qg
Qg
Qg
Qg
Qg
Qg
Qg
Qg
Qg
Qg
Qg
Qg
Qg
Qg
fQ
AO
"}
(10,1,1) = {"
QZ
QZ
QZ
QZ
QZ
QZ
QZ
QZ
QZ
QZ
QZ
QZ
QZ
QZ
QZ
QZ
QZ
QZ
QZ
QZ
QZ
QZ
QZ
QZ
QZ
AO
AO
AO
AO
AO
AO
AO
AO
AO
AO
AO
nJ
nJ
mh
mh
mh
mh
mh
mh
mh
nJ
nJ
nJ
gB
gB
gB
gB
nJ
fQ
Qg
Qg
Qg
Qg
Qg
Qg
Qg
Qg
Qg
Qg
Qg
Qg
Qg
Qg
Qg
Qg
Qg
Qg
Qg
fQ
AO
"}
(11,1,1) = {"
QZ
QZ
QZ
QZ
QZ
QZ
QZ
QZ
QZ
QZ
QZ
QZ
QZ
QZ
QZ
QZ
QZ
QZ
QZ
QZ
QZ
QZ
QZ
QZ
QZ
AO
AO
AO
AO
AO
AO
AO
AO
AO
AO
nJ
nJ
nJ
mh
mh
mh
mh
mh
mh
mh
mh
mh
mh
Dg
mh
mh
gB
nJ
fQ
Qg
Qg
Qg
Qg
Qg
Qg
Qg
Qg
Qg
Qg
Qg
Qg
Qg
Qg
Qg
Qg
Qg
Qg
Qg
fQ
AO
"}
(12,1,1) = {"
QZ
QZ
QZ
QZ
QZ
QZ
QZ
QZ
QZ
QZ
QZ
QZ
QZ
QZ
QZ
QZ
QZ
QZ
QZ
QZ
QZ
QZ
QZ
QZ
QZ
AO
AO
AO
AO
AO
AO
AO
AO
AO
AO
nJ
nJ
nJ
mh
mh
mh
mh
mh
mh
mh
mh
mh
mh
Dg
mh
mh
gB
nJ
fQ
Qg
Qg
Qg
Qg
Qg
Qg
Qg
Qg
Qg
Qg
Qg
Qg
Qg
Qg
Qg
Qg
Qg
Qg
Qg
fQ
AO
"}
(13,1,1) = {"
QZ
QZ
QZ
QZ
QZ
QZ
QZ
QZ
QZ
QZ
QZ
QZ
QZ
QZ
QZ
QZ
QZ
QZ
QZ
QZ
QZ
QZ
QZ
QZ
QZ
AO
AO
AO
AO
AO
AO
AO
AO
AO
AO
nJ
nJ
nJ
mh
mh
mh
mh
mh
mh
mh
mh
mh
mh
Dg
mh
mh
gB
nJ
fQ
Qg
Qg
Qg
Qg
Qg
Qg
Qg
Qg
Qg
Qg
Qg
Qg
Qg
Qg
Qg
Qg
Qg
Qg
Qg
fQ
AO
"}
(14,1,1) = {"
QZ
QZ
QZ
QZ
QZ
QZ
QZ
QZ
QZ
QZ
QZ
QZ
QZ
QZ
QZ
QZ
QZ
QZ
QZ
QZ
QZ
QZ
QZ
QZ
QZ
AO
AO
AO
AO
AO
AO
AO
nJ
nJ
nJ
nJ
nJ
nJ
mh
mh
mh
mh
mh
mh
mh
mh
mh
mh
Dg
mh
mh
gB
nJ
fQ
Qg
Qg
Qg
Qg
Qg
Qg
Qg
Qg
Qg
Qg
Qg
Qg
Qg
Qg
Qg
Qg
Qg
Qg
Qg
fQ
AO
"}
(15,1,1) = {"
QZ
QZ
QZ
QZ
QZ
QZ
QZ
QZ
QZ
QZ
QZ
QZ
QZ
QZ
QZ
QZ
QZ
QZ
QZ
QZ
QZ
QZ
QZ
QZ
AO
AO
AO
AO
AO
AO
AO
AO
nJ
nJ
nJ
nJ
nJ
nJ
mh
mh
mh
mh
mh
mh
mh
mh
mh
mh
Dg
mh
mh
gB
nJ
fQ
Qg
Qg
Qg
Qg
Qg
Qg
Qg
Qg
Qg
Qg
Qg
Qg
Qg
Qg
Qg
Qg
Qg
Qg
Qg
fQ
AO
"}
(16,1,1) = {"
QZ
QZ
QZ
QZ
QZ
QZ
QZ
QZ
QZ
QZ
QZ
QZ
QZ
QZ
QZ
QZ
QZ
QZ
QZ
QZ
QZ
QZ
QZ
QZ
QZ
QZ
QZ
QZ
QZ
QZ
QZ
QZ
QZ
QZ
nJ
nJ
nJ
nJ
mh
mh
mh
mh
mh
mh
mh
gB
mh
mh
gB
gB
gB
gB
nJ
fQ
Qg
Qg
Qg
Qg
Qg
Qg
Qg
Qg
Qg
Qg
Qg
Qg
Qg
Qg
Qg
Qg
Qg
Qg
Qg
fQ
AO
"}
(17,1,1) = {"
QZ
QZ
QZ
QZ
QZ
QZ
QZ
QZ
QZ
QZ
QZ
QZ
QZ
QZ
QZ
QZ
QZ
QZ
QZ
QZ
QZ
QZ
QZ
QZ
QZ
AO
gB
gB
gB
gB
gB
gB
gB
AO
nJ
nJ
gB
gB
gB
Bc
Bc
gB
gB
gB
gB
gB
mh
mh
mh
Fu
Fu
gB
nJ
fQ
Qg
Qg
Qg
Qg
Qg
Qg
Qg
Qg
Qg
Qg
Qg
Qg
Qg
Qg
Qg
Qg
Qg
Qg
Qg
fQ
AO
"}
(18,1,1) = {"
QZ
QZ
QZ
QZ
QZ
QZ
QZ
QZ
QZ
QZ
QZ
QZ
QZ
QZ
QZ
QZ
QZ
QZ
QZ
QZ
QZ
QZ
QZ
QZ
QZ
gB
gB
zC
zC
zC
zC
zC
gB
gB
nJ
nJ
gB
zC
zC
zC
zC
zC
zC
gB
gB
gB
mh
mh
gB
Fu
Fu
gB
nJ
fQ
Qg
Mw
Qg
Qg
Qg
Qg
Qg
Qg
Qg
Qg
Qg
Qg
Qg
Qg
Qg
Qg
Qg
bc
Qg
fQ
AO
"}
(19,1,1) = {"
QZ
QZ
QZ
QZ
QZ
QZ
QZ
QZ
QZ
QZ
QZ
QZ
QZ
QZ
QZ
QZ
QZ
QZ
QZ
QZ
QZ
QZ
QZ
QZ
QZ
gB
zC
zC
zC
zC
zC
zC
zC
gB
gB
gB
gB
wV
zC
uh
uh
zC
uh
uh
gB
gB
mh
mh
gB
Fu
Fu
gB
nJ
fQ
Qg
Qg
Qg
Qg
Qg
Qg
Qg
Qg
PJ
PJ
PJ
Qg
Qg
Qg
Qg
Qg
Qg
Qg
Qg
fQ
AO
"}
(20,1,1) = {"
QZ
QZ
QZ
QZ
QZ
QZ
QZ
QZ
QZ
QZ
QZ
QZ
QZ
QZ
QZ
QZ
QZ
QZ
QZ
QZ
QZ
QZ
QZ
QZ
QZ
gB
zC
LQ
Va
Va
Va
uj
zC
yO
zC
zC
Dd
zC
zC
uh
uh
zC
uh
uh
gB
gB
mh
mh
gB
gB
gB
gB
gB
fQ
fQ
fQ
fQ
fQ
fQ
fQ
fQ
fQ
aE
Ow
tY
fQ
fQ
fQ
fQ
fQ
fQ
fQ
fQ
fQ
AO
"}
(21,1,1) = {"
QZ
QZ
QZ
QZ
QZ
QZ
QZ
QZ
QZ
QZ
QZ
QZ
QZ
QZ
QZ
QZ
QZ
QZ
QZ
QZ
QZ
QZ
QZ
QZ
QZ
gB
zC
LQ
Va
Lj
Va
uj
zC
gB
zC
rs
pu
GA
Fu
Fu
Fu
Fu
Fu
Fu
mh
mh
mh
mh
Kk
Fu
Fu
Fu
Nx
Wx
Wx
Wx
Wx
Wx
Wx
Wx
Wx
Wx
Xd
Vc
Eh
Wx
Wx
Wx
Wx
Wx
Wx
Wx
Wx
Wx
AO
"}
(22,1,1) = {"
QZ
QZ
QZ
QZ
QZ
QZ
QZ
QZ
QZ
QZ
QZ
QZ
QZ
QZ
QZ
QZ
QZ
QZ
QZ
QZ
QZ
QZ
QZ
QZ
QZ
gB
zC
LQ
Va
zC
Va
uj
zC
gB
zC
io
Tv
tt
Fu
Fu
Fu
Fu
Fu
Fu
mh
mh
mh
mh
Kk
Fu
Fu
Fu
pI
Vc
Vc
Vc
Vc
Vc
Vc
Vc
Vc
Vc
Vc
Vc
Vc
Vc
Vc
Vc
Vc
Vc
Vc
Vc
Vc
Vc
AO
"}
(23,1,1) = {"
QZ
QZ
QZ
QZ
QZ
QZ
QZ
QZ
QZ
QZ
QZ
QZ
QZ
QZ
QZ
QZ
QZ
QZ
QZ
QZ
QZ
QZ
QZ
QZ
QZ
gB
zC
LQ
Va
Va
Va
uj
zC
yO
zC
zC
Dd
zC
zC
uh
uh
zC
uh
uh
gB
gB
mh
mh
Kk
Fu
Fu
Fu
Kk
OS
OS
OS
OS
OS
OS
OS
OS
OS
QT
Vc
nv
OS
OS
OS
OS
OS
OS
OS
OS
OS
AO
"}
(24,1,1) = {"
QZ
QZ
QZ
QZ
QZ
QZ
QZ
QZ
QZ
QZ
QZ
QZ
QZ
QZ
QZ
QZ
QZ
QZ
QZ
QZ
QZ
QZ
QZ
QZ
QZ
gB
zC
zC
zC
zC
zC
zC
zC
gB
gB
gB
gB
wV
zC
uh
uh
zC
uh
uh
gB
gB
mh
mh
gB
mh
mh
gB
gB
fQ
fQ
fQ
fQ
fQ
fQ
fQ
fQ
fQ
Yh
Vc
kG
fQ
fQ
fQ
fQ
fQ
fQ
fQ
fQ
fQ
AO
"}
(25,1,1) = {"
QZ
QZ
QZ
QZ
QZ
QZ
QZ
QZ
QZ
QZ
QZ
QZ
QZ
QZ
QZ
QZ
QZ
QZ
QZ
QZ
QZ
QZ
QZ
QZ
QZ
gB
gB
zC
zC
zC
zC
zC
gB
gB
nJ
nJ
gB
zC
zC
zC
zC
zC
zC
gB
gB
gB
mh
mh
gB
mh
mh
gB
nJ
fQ
Qg
Qg
Qg
Qg
Qg
Qg
Qg
fQ
Yh
Vc
kG
fQ
Qg
Qg
Qg
Qg
Qg
Qg
Qg
fQ
AO
"}
(26,1,1) = {"
QZ
QZ
QZ
QZ
QZ
QZ
QZ
QZ
QZ
QZ
QZ
QZ
QZ
QZ
QZ
QZ
QZ
QZ
QZ
QZ
QZ
QZ
QZ
QZ
QZ
AO
gB
gB
gB
gB
gB
gB
gB
nJ
nJ
nJ
gB
gB
gB
gX
gX
gB
gB
gB
nJ
gB
mh
mh
mh
mh
mh
gB
nJ
fQ
Qg
vh
Qg
Qg
Qg
Dv
Qg
fQ
Yh
Vc
kG
fQ
Qg
vh
Qg
Qg
Qg
Dv
Qg
fQ
AO
"}
(27,1,1) = {"
QZ
QZ
QZ
QZ
QZ
QZ
QZ
QZ
QZ
QZ
QZ
QZ
QZ
QZ
QZ
QZ
QZ
QZ
QZ
QZ
QZ
QZ
QZ
QZ
QZ
QZ
QZ
QZ
QZ
QZ
QZ
QZ
QZ
QZ
nJ
nJ
nJ
nJ
nJ
mh
mh
nJ
nJ
nJ
nJ
gB
mh
mh
gB
gB
gB
gB
nJ
fQ
Qg
Qg
Qg
Qg
Qg
Qg
Qg
fQ
Yh
Vc
kG
fQ
Qg
Qg
Qg
Qg
Qg
Qg
Qg
fQ
AO
"}
(28,1,1) = {"
QZ
QZ
QZ
QZ
QZ
QZ
QZ
QZ
QZ
QZ
QZ
QZ
QZ
QZ
QZ
QZ
QZ
QZ
QZ
QZ
QZ
QZ
QZ
QZ
AO
AO
AO
AO
AO
AO
AO
AO
nJ
nJ
nJ
nJ
nJ
mh
mh
nJ
nJ
nJ
nJ
nJ
nJ
gB
mh
mh
gB
nJ
nJ
nJ
nJ
fQ
Qg
Qg
Qg
Qg
Qg
Qg
Qg
fQ
Yh
Vc
kG
fQ
Qg
Qg
Qg
Qg
Qg
Qg
Qg
fQ
AO
"}
(29,1,1) = {"
QZ
QZ
QZ
QZ
QZ
QZ
QZ
QZ
QZ
QZ
QZ
QZ
QZ
QZ
QZ
QZ
QZ
QZ
QZ
QZ
QZ
QZ
QZ
QZ
QZ
AO
AO
AO
AO
AO
AO
nJ
nJ
nJ
nJ
nJ
nJ
nJ
nJ
nJ
nJ
nJ
nJ
nJ
nJ
nJ
nJ
nJ
nJ
nJ
nJ
nJ
nJ
fQ
si
Qg
Qg
Qg
Qg
Qg
nS
rs
Xd
Vc
Eh
ij
si
Qg
Qg
Qg
Qg
Qg
nS
fQ
AO
"}
(30,1,1) = {"
QZ
QZ
QZ
QZ
QZ
QZ
QZ
QZ
QZ
QZ
QZ
QZ
QZ
QZ
QZ
QZ
QZ
QZ
QZ
QZ
QZ
QZ
QZ
QZ
QZ
AO
AO
AO
AO
AO
AO
nJ
nJ
nJ
nJ
nJ
nJ
nJ
nJ
nJ
nJ
nJ
nJ
nJ
nJ
nJ
nJ
nJ
nJ
nJ
nJ
nJ
nJ
fQ
si
Qg
Qg
Qg
Qg
Qg
nS
io
QT
Vc
nv
qk
si
Qg
Qg
Qg
Qg
Qg
nS
fQ
AO
"}
(31,1,1) = {"
QZ
QZ
QZ
QZ
QZ
QZ
QZ
QZ
QZ
QZ
QZ
QZ
QZ
QZ
QZ
QZ
QZ
QZ
QZ
QZ
QZ
QZ
QZ
QZ
QZ
AO
AO
AO
AO
AO
AO
nJ
nJ
nJ
nJ
nJ
nJ
nJ
nJ
nJ
nJ
nJ
nJ
nJ
nJ
nJ
nJ
nJ
nJ
nJ
nJ
nJ
nJ
fQ
Qg
Qg
Qg
Qg
Qg
Qg
Qg
fQ
Yh
Vc
kG
fQ
Qg
Qg
Qg
Qg
Qg
Qg
Qg
fQ
AO
"}
(32,1,1) = {"
QZ
QZ
QZ
QZ
QZ
QZ
QZ
QZ
QZ
QZ
QZ
QZ
QZ
QZ
QZ
QZ
QZ
QZ
QZ
QZ
QZ
QZ
QZ
QZ
QZ
AO
AO
AO
AO
AO
AO
nJ
nJ
nJ
nJ
nJ
nJ
nJ
nJ
nJ
nJ
nJ
nJ
nJ
nJ
nJ
nJ
nJ
nJ
nJ
nJ
nJ
nJ
fQ
Qg
Qg
Qg
Qg
Qg
Qg
Qg
fQ
Yh
Vc
kG
fQ
Qg
Qg
Qg
Qg
Qg
Qg
Qg
fQ
AO
"}
(33,1,1) = {"
QZ
QZ
QZ
QZ
QZ
QZ
QZ
QZ
QZ
QZ
QZ
QZ
QZ
QZ
QZ
QZ
QZ
QZ
QZ
QZ
QZ
QZ
QZ
QZ
QZ
AO
AO
AO
AO
AO
AO
nJ
nJ
nJ
nJ
nJ
nJ
nJ
nJ
nJ
nJ
nJ
nJ
nJ
nJ
nJ
nJ
nJ
nJ
nJ
nJ
nJ
nJ
fQ
Qg
Mw
Qg
Qg
Qg
bc
Qg
fQ
Yh
Vc
kG
fQ
Qg
Mw
Qg
Qg
Qg
bc
Qg
fQ
AO
"}
(34,1,1) = {"
QZ
QZ
QZ
QZ
QZ
QZ
QZ
QZ
QZ
QZ
QZ
QZ
QZ
QZ
QZ
QZ
QZ
QZ
QZ
QZ
QZ
QZ
QZ
QZ
QZ
AO
AO
AO
AO
AO
AO
nJ
nJ
nJ
nJ
nJ
nJ
nJ
nJ
nJ
nJ
nJ
nJ
nJ
nJ
nJ
nJ
nJ
nJ
nJ
nJ
nJ
nJ
fQ
Qg
Qg
Qg
Qg
Qg
Qg
Qg
fQ
Yh
Vc
kG
fQ
Qg
Qg
Qg
Qg
Qg
Qg
Qg
fQ
AO
"}
(35,1,1) = {"
QZ
QZ
QZ
QZ
QZ
QZ
QZ
QZ
QZ
QZ
QZ
QZ
QZ
QZ
QZ
QZ
QZ
QZ
QZ
QZ
QZ
QZ
QZ
QZ
QZ
AO
AO
AO
AO
AO
AO
nJ
nJ
nJ
nJ
nJ
nJ
nJ
nJ
nJ
nJ
nJ
nJ
nJ
nJ
nJ
nJ
nJ
nJ
nJ
nJ
nJ
nJ
fQ
fQ
fQ
fQ
fQ
fQ
fQ
fQ
fQ
Yh
Vc
kG
fQ
fQ
fQ
fQ
fQ
fQ
fQ
fQ
fQ
AO
"}
(36,1,1) = {"
QZ
QZ
QZ
QZ
QZ
QZ
QZ
QZ
QZ
QZ
QZ
QZ
QZ
QZ
QZ
QZ
QZ
QZ
QZ
QZ
QZ
QZ
QZ
QZ
QZ
AO
AO
AO
AO
AO
AO
nJ
nJ
nJ
nJ
nJ
nJ
nJ
nJ
nJ
nJ
nJ
nJ
nJ
nJ
nJ
nJ
nJ
nJ
nJ
nJ
nJ
nJ
Re
nJ
nJ
nJ
nJ
nJ
nJ
nJ
nJ
nJ
nJ
nJ
nJ
nJ
nJ
nJ
nJ
AO
AO
AO
AO
AO
"}
(37,1,1) = {"
QZ
QZ
QZ
QZ
QZ
QZ
QZ
QZ
QZ
QZ
QZ
QZ
QZ
QZ
QZ
QZ
QZ
QZ
QZ
QZ
QZ
QZ
QZ
QZ
QZ
AO
AO
AO
AO
AO
AO
nJ
nJ
nJ
nJ
nJ
nJ
nJ
nJ
nJ
nJ
nJ
nJ
nJ
nJ
nJ
nJ
nJ
nJ
nJ
nJ
nJ
nJ
nJ
nJ
nJ
nJ
nJ
nJ
nJ
nJ
nJ
nJ
nJ
AO
AO
AO
AO
AO
AO
AO
AO
AO
AO
AO
"}
(38,1,1) = {"
QZ
QZ
QZ
QZ
QZ
QZ
QZ
QZ
QZ
QZ
QZ
QZ
QZ
QZ
QZ
QZ
QZ
QZ
QZ
QZ
QZ
QZ
QZ
QZ
QZ
AO
AO
AO
AO
AO
AO
nJ
nJ
nJ
nJ
nJ
nJ
nJ
nJ
nJ
nJ
nJ
nJ
nJ
nJ
nJ
nJ
nJ
nJ
nJ
nJ
nJ
nJ
nJ
nJ
nJ
nJ
nJ
nJ
nJ
nJ
nJ
nJ
nJ
AO
AO
AO
AO
AO
AO
AO
AO
AO
AO
AO
"}
(39,1,1) = {"
QZ
QZ
QZ
QZ
QZ
QZ
QZ
QZ
QZ
QZ
QZ
QZ
QZ
QZ
QZ
QZ
QZ
QZ
QZ
QZ
QZ
QZ
QZ
QZ
QZ
AO
AO
AO
AO
AO
AO
nJ
nJ
nJ
nJ
nJ
nJ
nJ
nJ
nJ
nJ
nJ
nJ
nJ
nJ
nJ
nJ
nJ
nJ
nJ
nJ
nJ
nJ
nJ
nJ
nJ
nJ
nJ
nJ
nJ
nJ
nJ
nJ
nJ
AO
AO
AO
AO
AO
AO
AO
AO
AO
AO
AO
"}
(40,1,1) = {"
QZ
QZ
QZ
QZ
QZ
QZ
QZ
QZ
QZ
QZ
QZ
QZ
QZ
QZ
QZ
QZ
QZ
QZ
QZ
QZ
QZ
QZ
QZ
QZ
QZ
AO
AO
AO
AO
AO
AO
nJ
nJ
nJ
nJ
nJ
nJ
nJ
nJ
nJ
nJ
nJ
nJ
nJ
nJ
nJ
nJ
nJ
nJ
nJ
nJ
nJ
nJ
nJ
nJ
nJ
nJ
nJ
nJ
nJ
nJ
nJ
nJ
nJ
AO
AO
AO
AO
AO
AO
AO
AO
AO
AO
AO
"}
(41,1,1) = {"
QZ
QZ
QZ
QZ
QZ
QZ
QZ
QZ
QZ
QZ
QZ
QZ
QZ
QZ
QZ
QZ
QZ
QZ
QZ
QZ
QZ
QZ
QZ
QZ
QZ
AO
AO
AO
AO
AO
AO
nJ
nJ
nJ
nJ
nJ
nJ
nJ
nJ
nJ
nJ
nJ
nJ
nJ
nJ
nJ
nJ
nJ
nJ
nJ
nJ
nJ
nJ
nJ
nJ
nJ
nJ
nJ
nJ
nJ
nJ
nJ
nJ
nJ
AO
AO
AO
AO
AO
AO
AO
AO
AO
AO
AO
"}
(42,1,1) = {"
QZ
QZ
QZ
QZ
QZ
QZ
QZ
QZ
QZ
QZ
QZ
QZ
QZ
QZ
QZ
QZ
QZ
QZ
QZ
QZ
QZ
QZ
QZ
QZ
QZ
AO
AO
AO
AO
AO
AO
nJ
nJ
nJ
nJ
nJ
nJ
nJ
nJ
nJ
nJ
nJ
nJ
nJ
nJ
nJ
nJ
nJ
nJ
nJ
nJ
nJ
nJ
nJ
nJ
nJ
nJ
nJ
nJ
nJ
nJ
nJ
nJ
nJ
AO
AO
AO
AO
AO
AO
AO
AO
AO
AO
AO
"}
(43,1,1) = {"
QZ
QZ
QZ
QZ
QZ
QZ
QZ
QZ
QZ
QZ
QZ
QZ
QZ
QZ
QZ
QZ
QZ
QZ
QZ
QZ
QZ
QZ
QZ
QZ
QZ
AO
AO
AO
AO
AO
AO
nJ
nJ
nJ
nJ
nJ
nJ
nJ
nJ
nJ
nJ
nJ
nJ
nJ
nJ
nJ
nJ
nJ
nJ
nJ
nJ
nJ
nJ
nJ
nJ
nJ
nJ
nJ
nJ
nJ
AO
AO
AO
AO
AO
AO
AO
AO
AO
AO
AO
AO
AO
AO
AO
"}
(44,1,1) = {"
QZ
QZ
QZ
QZ
QZ
QZ
QZ
QZ
QZ
QZ
QZ
QZ
QZ
QZ
QZ
QZ
QZ
QZ
QZ
QZ
QZ
QZ
QZ
QZ
QZ
AO
AO
AO
AO
AO
AO
AO
AO
AO
AO
AO
AO
AO
AO
nJ
nJ
nJ
nJ
nJ
nJ
nJ
nJ
nJ
nJ
nJ
nJ
nJ
nJ
nJ
nJ
nJ
nJ
nJ
nJ
nJ
AO
AO
AO
AO
AO
AO
AO
AO
AO
hu
wo
Jw
wo
hu
AO
"}
(45,1,1) = {"
QZ
QZ
QZ
QZ
QZ
QZ
QZ
QZ
QZ
QZ
QZ
QZ
QZ
QZ
QZ
QZ
QZ
QZ
QZ
QZ
QZ
QZ
QZ
QZ
QZ
AO
AO
AO
AO
AO
AO
AO
AO
AO
AO
AO
AO
AO
AO
AO
AO
nJ
nJ
nJ
nJ
nJ
nJ
nJ
nJ
nJ
nJ
nJ
nJ
nJ
nJ
nJ
nJ
nJ
nJ
nJ
AO
AO
AO
AO
AO
AO
AO
AO
hu
wo
Fu
Fu
Fu
wo
hu
"}
(46,1,1) = {"
QZ
QZ
QZ
QZ
QZ
QZ
QZ
QZ
QZ
QZ
QZ
QZ
QZ
QZ
QZ
QZ
QZ
QZ
QZ
QZ
QZ
QZ
QZ
QZ
QZ
AO
AO
AO
AO
AO
AO
AO
AO
AO
AO
AO
AO
AO
AO
AO
AO
AO
AO
AO
AO
AO
nJ
nJ
nJ
nJ
nJ
nJ
nJ
nJ
nJ
nJ
nJ
nJ
nJ
nJ
AO
AO
AO
AO
AO
AO
AO
AO
wo
Fu
Fu
Fu
Fu
Fu
wo
"}
(47,1,1) = {"
QZ
QZ
QZ
QZ
QZ
QZ
QZ
QZ
QZ
QZ
QZ
QZ
QZ
QZ
QZ
QZ
QZ
QZ
QZ
QZ
QZ
QZ
QZ
QZ
QZ
AO
AO
AO
AO
AO
AO
AO
AO
AO
AO
AO
AO
AO
AO
AO
AO
AO
AO
AO
AO
AO
AO
AO
AO
AO
AO
nJ
nJ
nJ
nJ
nJ
nJ
nJ
nJ
nJ
AO
AO
AO
AO
AO
AO
AO
AO
Rr
Fu
Fu
wo
Fu
Fu
Rr
"}
(48,1,1) = {"
QZ
QZ
QZ
QZ
QZ
QZ
QZ
QZ
QZ
QZ
QZ
QZ
QZ
QZ
QZ
QZ
QZ
QZ
QZ
QZ
QZ
QZ
QZ
QZ
QZ
AO
AO
AO
AO
AO
AO
AO
AO
AO
AO
AO
AO
AO
AO
AO
AO
AO
AO
AO
AO
AO
AO
AO
AO
AO
AO
nJ
nJ
nJ
nJ
nJ
nJ
nJ
nJ
nJ
AO
AO
AO
AO
AO
AO
AO
AO
wo
Fu
Fu
Fu
Fu
Fu
wo
"}
(49,1,1) = {"
QZ
QZ
QZ
QZ
QZ
QZ
QZ
QZ
QZ
QZ
QZ
QZ
QZ
QZ
QZ
QZ
QZ
QZ
QZ
QZ
QZ
QZ
QZ
QZ
QZ
AO
AO
AO
AO
AO
AO
AO
AO
AO
AO
AO
AO
AO
AO
AO
AO
AO
AO
AO
AO
AO
AO
AO
AO
AO
AO
AO
AO
AO
AO
AO
AO
AO
AO
AO
AO
AO
AO
AO
AO
AO
AO
AO
wo
wo
Fu
Fu
Fu
wo
wo
"}
(50,1,1) = {"
QZ
QZ
QZ
QZ
QZ
QZ
QZ
QZ
QZ
QZ
QZ
QZ
QZ
QZ
QZ
QZ
QZ
QZ
QZ
QZ
QZ
QZ
QZ
QZ
QZ
AO
AO
AO
AO
AO
AO
AO
AO
AO
AO
AO
AO
AO
AO
AO
AO
AO
AO
AO
AO
AO
AO
AO
AO
AO
AO
AO
AO
AO
AO
AO
AO
AO
AO
AO
AO
AO
AO
AO
AO
AO
AO
AO
AO
wo
wo
Jw
wo
wo
AO
"}
