//MAP CONVERTED BY dmm2tgm.py THIS HEADER COMMENT PREVENTS RECONVERSION, DO NOT REMOVE
"a" = (
/turf/closed/mineral/random/whitesands,
/area/space)
"c" = (
/turf/closed/wall/mineral/plastitanium,
/area/space)
"e" = (
/obj/machinery/door/airlock/centcom{
	name = "Assault Pod";
	req_access_txt = "150"
	},
/turf/open/floor/plating/asteroid/whitesands/lit,
/area/space)
"h" = (
/obj/machinery/door/poddoor/shutters,
/turf/open/floor/plating,
/area/space)
"j" = (
/turf/open/floor/plating/asteroid/whitesands/lit,
/area/space)
"o" = (
/obj/machinery/door/poddoor/shutters,
/turf/open/floor/mineral/plastitanium/red,
/area/space)
"p" = (
/obj/machinery/door/airlock/centcom{
	aiControlDisabled = 1;
	name = "Assault Pod";
	req_access_txt = "150";
	dir = 4
	},
/turf/open/floor/plating/asteroid/whitesands/lit,
/area/space)
"z" = (
/obj/machinery/door/airlock/centcom{
	name = "Assault Pod";
	req_access_txt = "150"
	},
/turf/open/floor/plating,
/area/space)
"A" = (
/obj/machinery/porta_turret/ship/ballistic,
/turf/closed/wall/mineral/plastitanium,
/area/space)
"E" = (
/obj/structure/bed/double/maint,
/turf/open/floor/mineral/plastitanium/red,
/area/space)
"K" = (
/turf/open/floor/mineral/plastitanium/red,
/area/space)
"N" = (
/obj/structure/poddoor_assembly/shutters,
/turf/open/floor/mineral/plastitanium/red,
/area/space)
"X" = (
/turf/open/floor/plating,
/area/space)
"Z" = (
/obj/machinery/door/airlock/centcom{
	aiControlDisabled = 1;
	name = "Assault Pod";
	req_access_txt = "150";
	dir = 4
	},
/turf/open/floor/plating,
/area/space)

(1,1,1) = {"
j
j
j
j
j
j
j
j
j
j
j
j
j
j
j
j
j
j
j
j
j
j
j
j
j
j
j
j
j
j
j
j
j
j
j
j
j
j
j
j
j
j
j
j
j
j
j
j
j
j
"}
(2,1,1) = {"
j
j
j
j
j
j
j
j
j
j
j
j
j
j
j
j
j
j
j
j
j
j
j
j
j
j
j
j
j
j
j
j
j
j
j
j
j
j
j
j
j
j
j
j
j
j
j
j
j
j
"}
(3,1,1) = {"
j
j
j
j
j
j
j
j
j
j
j
j
j
j
j
j
j
j
j
j
j
j
j
j
j
j
j
j
j
j
j
j
j
j
j
j
j
j
j
j
j
j
j
j
j
j
j
j
j
j
"}
(4,1,1) = {"
j
j
j
j
j
j
j
j
j
j
j
j
j
j
j
j
j
j
j
j
j
j
j
j
j
j
j
j
j
j
j
j
j
j
j
j
j
j
j
j
j
j
j
j
j
j
j
j
j
j
"}
(5,1,1) = {"
j
j
j
j
j
j
j
j
j
j
j
j
j
j
j
j
j
j
j
j
j
j
j
j
j
j
j
j
j
j
j
j
j
j
j
j
j
j
j
j
j
j
j
j
j
j
j
j
j
j
"}
(6,1,1) = {"
j
j
j
j
j
j
j
j
j
j
j
j
j
j
j
j
j
j
j
j
j
j
j
a
a
a
a
a
a
j
j
j
j
j
j
j
j
j
j
j
j
j
j
j
j
j
j
j
j
j
"}
(7,1,1) = {"
j
j
j
j
j
j
j
j
j
j
j
j
j
j
j
j
j
j
j
j
j
j
j
a
a
a
a
a
a
a
a
a
a
a
a
a
a
a
a
j
j
j
j
j
j
j
j
j
j
j
"}
(8,1,1) = {"
j
j
j
j
j
j
j
j
j
j
j
j
j
j
j
j
a
a
a
a
a
a
a
a
a
a
a
a
a
a
a
a
a
a
a
a
a
a
a
j
j
j
j
j
j
j
j
j
j
j
"}
(9,1,1) = {"
j
j
j
j
j
j
j
j
j
j
j
a
a
a
a
a
a
a
a
a
a
a
a
a
a
a
a
a
a
a
a
c
c
Z
c
c
a
a
a
j
j
j
j
j
j
j
j
j
j
j
"}
(10,1,1) = {"
j
j
j
j
j
j
j
j
j
j
j
a
a
a
a
a
a
a
a
a
a
a
a
a
a
a
a
a
a
a
c
c
K
K
K
c
c
j
j
j
j
j
j
j
j
j
j
j
j
j
"}
(11,1,1) = {"
j
j
j
j
j
j
j
j
j
j
a
a
a
a
a
a
a
a
a
a
a
a
a
a
a
a
a
a
a
a
c
K
K
K
K
K
c
j
j
j
j
j
j
j
j
j
j
j
j
j
"}
(12,1,1) = {"
j
j
j
j
j
j
j
j
j
j
a
a
a
a
a
a
a
a
a
a
a
a
a
a
a
a
a
j
j
j
z
K
K
c
K
K
z
j
j
j
j
j
j
j
j
j
j
j
j
j
"}
(13,1,1) = {"
j
j
j
j
j
j
j
j
j
j
a
a
a
a
a
a
a
a
a
a
a
a
a
a
a
a
a
j
j
j
c
E
K
K
K
K
c
j
j
j
j
j
j
j
j
j
j
j
j
j
"}
(14,1,1) = {"
j
j
j
j
j
j
j
a
a
a
a
a
a
a
a
a
a
a
a
a
a
a
a
a
a
a
a
j
j
j
A
c
K
K
K
c
A
j
j
j
j
j
j
j
j
j
j
j
j
j
"}
(15,1,1) = {"
j
j
j
j
j
j
j
a
a
a
a
a
a
a
a
a
a
a
a
a
a
a
a
a
a
a
a
a
j
j
j
A
c
Z
c
A
j
j
j
j
j
j
j
j
j
j
j
j
j
j
"}
(16,1,1) = {"
j
j
j
j
j
j
j
a
a
a
a
a
a
a
a
a
a
a
a
a
a
a
a
a
a
a
a
a
j
j
j
j
j
j
j
j
j
j
j
j
j
j
j
j
j
j
j
j
j
j
"}
(17,1,1) = {"
j
j
j
j
j
j
a
a
a
a
a
a
a
a
a
a
a
a
a
a
a
a
a
a
a
a
a
a
j
j
j
j
j
j
j
j
j
j
j
j
j
j
j
j
j
j
j
j
j
j
"}
(18,1,1) = {"
j
j
j
j
j
j
a
a
a
a
a
a
a
a
a
a
a
a
a
a
a
a
a
a
a
a
a
a
j
j
j
j
j
j
j
j
j
j
j
j
j
j
j
j
j
j
j
j
j
j
"}
(19,1,1) = {"
j
j
j
j
j
j
a
a
a
a
a
a
a
a
a
a
a
a
a
a
a
a
j
j
j
a
a
a
j
j
j
j
j
j
j
j
j
j
j
j
j
j
j
j
j
j
j
j
j
j
"}
(20,1,1) = {"
j
j
j
j
j
j
a
a
a
a
a
a
a
a
a
a
a
a
a
a
a
a
j
j
c
c
c
c
j
j
j
j
j
j
j
j
j
j
j
j
j
j
j
j
j
j
j
j
j
j
"}
(21,1,1) = {"
j
j
j
j
j
j
a
a
a
a
a
a
a
a
a
a
a
a
a
a
a
a
j
j
o
K
K
h
X
K
X
j
j
j
j
j
j
j
j
j
j
j
j
j
j
j
j
j
j
j
"}
(22,1,1) = {"
j
j
j
j
j
j
a
a
a
a
a
a
a
a
a
a
a
a
a
a
a
a
j
j
o
K
K
N
K
X
K
j
j
j
j
j
j
j
j
j
j
j
j
j
j
j
j
j
j
j
"}
(23,1,1) = {"
j
j
j
j
j
j
a
a
a
a
a
a
a
a
a
a
a
a
a
a
a
a
j
j
o
K
K
o
K
K
K
j
j
j
j
j
j
j
j
j
j
j
j
j
j
j
j
j
j
j
"}
(24,1,1) = {"
j
j
j
j
j
j
a
a
a
a
a
a
a
a
a
a
a
a
a
a
a
a
j
j
c
X
X
c
j
j
j
j
j
j
j
j
j
j
j
j
j
j
j
j
j
j
j
j
j
j
"}
(25,1,1) = {"
j
j
j
j
j
j
a
a
a
a
a
a
a
a
a
a
a
a
a
a
a
a
a
a
a
X
X
a
j
j
j
j
j
j
j
j
j
j
j
j
j
j
j
j
j
j
j
j
j
j
"}
(26,1,1) = {"
j
j
j
j
j
j
a
a
a
a
a
a
a
a
a
a
a
a
a
a
a
a
a
a
a
a
a
a
j
j
j
j
j
j
j
j
j
j
j
j
j
j
j
j
j
j
j
j
j
j
"}
(27,1,1) = {"
j
j
j
j
j
j
a
a
a
a
a
a
a
a
a
a
a
a
a
a
a
a
a
a
a
a
a
a
j
j
j
j
j
j
j
j
j
j
j
j
j
j
j
j
j
j
j
j
j
j
"}
(28,1,1) = {"
j
j
j
j
j
j
a
a
a
a
a
a
a
a
a
a
a
a
a
a
a
a
a
a
a
a
a
a
j
j
j
j
j
j
j
j
j
j
j
j
j
j
j
j
j
j
j
j
j
j
"}
(29,1,1) = {"
j
j
j
j
j
j
a
a
a
a
a
a
a
a
a
a
a
a
a
a
a
a
a
a
a
a
a
a
j
j
j
A
c
p
c
A
j
j
j
j
j
j
j
j
j
j
j
j
j
j
"}
(30,1,1) = {"
j
j
j
j
j
j
a
a
a
a
a
a
a
a
a
a
a
a
a
a
a
a
a
a
a
a
a
a
j
j
A
c
K
K
K
c
A
j
j
j
j
j
j
j
j
j
j
j
j
j
"}
(31,1,1) = {"
j
j
j
j
j
j
a
a
a
a
a
a
a
a
a
a
a
a
a
a
a
a
a
a
a
a
a
a
j
j
c
K
K
K
K
K
c
j
j
j
j
j
j
j
j
j
j
j
j
j
"}
(32,1,1) = {"
j
j
j
j
j
j
a
a
a
a
a
a
a
a
a
a
a
a
a
a
a
a
a
a
a
a
a
j
j
j
e
K
K
c
K
K
e
j
j
j
j
j
j
j
j
j
j
j
j
j
"}
(33,1,1) = {"
j
j
j
j
j
j
a
a
a
a
a
a
a
a
a
a
a
a
a
a
a
a
a
a
a
a
a
j
j
j
c
K
K
K
K
K
c
j
j
j
j
j
j
j
j
j
j
j
j
j
"}
(34,1,1) = {"
j
j
j
j
j
j
a
a
a
a
a
a
a
a
a
a
a
a
a
a
a
a
a
a
a
a
a
j
j
j
c
c
K
K
K
c
c
j
j
j
j
j
j
j
j
j
j
j
j
j
"}
(35,1,1) = {"
j
j
j
j
j
j
a
a
a
a
a
a
a
a
a
a
a
a
a
a
a
a
a
a
a
a
a
j
j
j
j
c
c
p
c
c
j
j
j
j
j
j
j
j
j
j
j
j
j
j
"}
(36,1,1) = {"
j
j
j
j
j
j
a
a
a
a
a
a
a
a
a
a
a
a
a
a
a
a
a
a
a
a
a
a
j
j
j
j
j
j
j
j
j
j
j
j
j
j
j
j
j
j
j
j
j
j
"}
(37,1,1) = {"
j
j
j
j
j
j
a
a
a
a
a
a
a
a
a
a
a
a
a
a
a
a
a
a
a
a
a
a
a
a
a
a
a
a
a
a
a
a
a
j
j
j
j
j
j
j
j
j
j
j
"}
(38,1,1) = {"
j
j
j
j
j
j
a
a
a
a
a
a
a
a
a
a
a
a
a
a
a
a
a
a
a
a
a
a
a
a
a
a
a
a
a
a
a
a
a
j
j
j
j
j
j
j
j
j
j
j
"}
(39,1,1) = {"
j
j
j
j
j
j
a
a
a
a
a
a
a
a
a
a
a
a
a
a
a
a
a
a
a
a
a
a
a
a
a
a
a
a
a
a
a
a
a
j
j
j
j
j
j
j
j
j
j
j
"}
(40,1,1) = {"
j
j
j
j
j
j
a
a
a
a
a
a
a
a
a
a
a
a
a
a
a
a
a
a
a
a
a
a
a
a
a
a
a
a
a
a
a
a
a
j
j
j
j
j
j
j
j
j
j
j
"}
(41,1,1) = {"
j
j
j
j
j
j
a
a
a
a
a
a
a
a
a
a
a
a
a
a
a
a
a
a
a
a
a
a
a
a
a
a
a
a
a
a
a
a
a
j
j
j
j
j
j
j
j
j
j
j
"}
(42,1,1) = {"
j
j
j
j
j
j
a
a
a
a
a
a
a
a
a
a
a
a
a
a
a
a
a
a
a
a
a
a
a
a
a
a
a
a
a
a
a
a
a
j
j
j
j
j
j
j
j
j
j
j
"}
(43,1,1) = {"
j
j
j
j
j
j
a
a
a
a
a
a
a
a
a
a
a
a
a
a
a
a
a
a
a
a
a
a
a
a
a
a
a
a
a
j
j
j
j
j
j
j
j
j
j
j
j
j
j
j
"}
(44,1,1) = {"
j
j
j
j
j
j
j
j
j
j
j
j
j
j
a
a
a
a
a
a
a
a
a
a
a
a
a
a
a
a
a
a
a
a
a
j
j
j
j
j
j
j
j
j
j
j
j
j
j
j
"}
(45,1,1) = {"
j
j
j
j
j
j
j
j
j
j
j
j
j
j
j
j
a
a
a
a
a
a
a
a
a
a
a
a
a
a
a
a
a
a
a
j
j
j
j
j
j
j
j
j
j
j
j
j
j
j
"}
(46,1,1) = {"
j
j
j
j
j
j
j
j
j
j
j
j
j
j
j
j
j
j
j
j
j
a
a
a
a
a
a
a
a
a
a
a
a
a
a
j
j
j
j
j
j
j
j
j
j
j
j
j
j
j
"}
(47,1,1) = {"
j
j
j
j
j
j
j
j
j
j
j
j
j
j
j
j
j
j
j
j
j
j
j
j
j
j
a
a
a
a
a
a
a
a
a
j
j
j
j
j
j
j
j
j
j
j
j
j
j
j
"}
(48,1,1) = {"
j
j
j
j
j
j
j
j
j
j
j
j
j
j
j
j
j
j
j
j
j
j
j
j
j
j
a
a
a
a
a
a
a
a
a
j
j
j
j
j
j
j
j
j
j
j
j
j
j
j
"}
(49,1,1) = {"
j
j
j
j
j
j
j
j
j
j
j
j
j
j
j
j
j
j
j
j
j
j
j
j
j
j
j
j
j
j
j
j
j
j
j
j
j
j
j
j
j
j
j
j
j
j
j
j
j
j
"}
(50,1,1) = {"
j
j
j
j
j
j
j
j
j
j
j
j
j
j
j
j
j
j
j
j
j
j
j
j
j
j
j
j
j
j
j
j
j
j
j
j
j
j
j
j
j
j
j
j
j
j
j
j
j
j
"}
