//MAP CONVERTED BY dmm2tgm.py THIS HEADER COMMENT PREVENTS RECONVERSION, DO NOT REMOVE
"aE" = (
/obj/structure/railing{
	dir = 1
	},
/turf/open/floor/plasteel/stairs{
	dir = 8
	},
/area/space)
"aY" = (
/obj/machinery/processor,
/turf/open/floor/plasteel/freezer,
/area/space)
"bc" = (
/obj/effect/turf_decal/industrial/warning{
	dir = 6
	},
/turf/open/floor/concrete,
/area/space)
"cs" = (
/obj/effect/turf_decal/syndicateemblem/top/middle,
/turf/open/floor/mineral/plastitanium/red,
/area/space)
"dq" = (
/obj/effect/turf_decal/syndicateemblem/middle/right,
/turf/open/floor/mineral/plastitanium/red,
/area/space)
"ea" = (
/turf/open/floor/plasteel/freezer,
/area/space)
"fQ" = (
/turf/open/floor/concrete/reinforced,
/area/space)
"gB" = (
/turf/closed/wall/r_wall/syndicate,
/area/space)
"gO" = (
/obj/effect/turf_decal/syndicateemblem/bottom/left,
/turf/open/floor/mineral/plastitanium/red,
/area/space)
"gX" = (
/obj/machinery/door/airlock/grunge,
/turf/open/floor/wood,
/area/space)
"hu" = (
/obj/machinery/porta_turret/ship/ballistic,
/turf/closed/wall/mineral/plastitanium,
/area/space)
"ij" = (
/obj/structure/railing{
	dir = 8
	},
/turf/open/floor/plasteel/stairs,
/area/space)
"io" = (
/obj/structure/railing{
	dir = 4
	},
/turf/open/floor/plasteel/stairs{
	dir = 1
	},
/area/space)
"iE" = (
/obj/machinery/door/airlock/centcom{
	aiControlDisabled = 1;
	name = "Assault Pod";
	req_access_txt = "150";
	dir = 4
	},
/turf/open/floor/plating,
/area/space)
"iF" = (
/obj/structure/sink{
	pixel_x = 2;
	pixel_y = 20
	},
/turf/open/floor/wood,
/area/space)
"jD" = (
/obj/machinery/door/airlock/grunge,
/turf/open/floor/plasteel/freezer,
/area/space)
"kj" = (
/obj/structure/table/reinforced,
/turf/open/floor/plating,
/area/space)
"kF" = (
/obj/machinery/door/airlock/grunge,
/turf/open/floor/plating,
/area/space)
"kG" = (
/obj/structure/railing,
/turf/open/floor/concrete/slab_1,
/area/space)
"mh" = (
/turf/open/floor/plating,
/area/space)
"ni" = (
/obj/effect/turf_decal/syndicateemblem/middle/middle,
/turf/open/floor/mineral/plastitanium/red,
/area/space)
"nv" = (
/obj/structure/railing/corner,
/turf/open/floor/concrete/slab_1,
/area/space)
"nx" = (
/obj/structure/bed/double/maint,
/turf/open/floor/mineral/plastitanium/red,
/area/space)
"nJ" = (
/turf/closed/mineral/random/whitesands,
/area/space)
"nS" = (
/obj/effect/turf_decal/industrial/stand_clear/white,
/turf/open/floor/concrete,
/area/space)
"nZ" = (
/obj/machinery/door/airlock/grunge{
	dir = 4
	},
/turf/open/floor/plating,
/area/space)
"pu" = (
/obj/structure/railing{
	dir = 8
	},
/turf/open/floor/mineral/plastitanium,
/area/space)
"pI" = (
/obj/structure/poddoor_assembly/shutters,
/turf/open/floor/mineral/plastitanium/red,
/area/space)
"qd" = (
/turf/open/floor/wood,
/area/space)
"qk" = (
/obj/structure/railing{
	dir = 4
	},
/turf/open/floor/plasteel/stairs,
/area/space)
"qp" = (
/obj/machinery/door/airlock/grunge{
	dir = 4
	},
/turf/closed/mineral/random/whitesands,
/area/space)
"qD" = (
/obj/effect/turf_decal/syndicateemblem/middle/left,
/turf/open/floor/mineral/plastitanium/red,
/area/space)
"rs" = (
/obj/structure/railing{
	dir = 8
	},
/turf/open/floor/plasteel/stairs{
	dir = 1
	},
/area/space)
"si" = (
/obj/effect/turf_decal/industrial/stand_clear/white{
	dir = 1
	},
/turf/open/floor/concrete,
/area/space)
"tk" = (
/obj/structure/catwalk,
/turf/open/floor/plating,
/area/space)
"tt" = (
/obj/structure/railing{
	dir = 6
	},
/obj/structure/table/reinforced,
/obj/item/folder/syndicate,
/obj/item/laser_pointer/red,
/turf/open/floor/mineral/plastitanium,
/area/space)
"tY" = (
/obj/structure/railing,
/turf/open/floor/plasteel/stairs{
	dir = 8
	},
/area/space)
"uh" = (
/obj/structure/chair/plastic{
	dir = 1
	},
/turf/open/floor/plasteel/dark,
/area/space)
"uj" = (
/obj/structure/chair/comfy/beige/directional/north,
/turf/open/floor/plasteel/dark,
/area/space)
"vh" = (
/obj/effect/turf_decal/industrial/warning{
	dir = 9
	},
/turf/open/floor/concrete,
/area/space)
"wd" = (
/obj/structure/table/reinforced,
/obj/item/storage/bag/tray/cafeteria{
	pixel_y = 3
	},
/obj/item/storage/bag/tray/cafeteria{
	pixel_y = 5
	},
/obj/item/storage/bag/tray/cafeteria{
	pixel_y = 7
	},
/obj/item/storage/bag/tray/cafeteria{
	pixel_y = 9
	},
/turf/open/floor/plasteel/dark,
/area/space)
"wi" = (
/obj/effect/turf_decal/syndicateemblem/bottom/middle,
/turf/open/floor/mineral/plastitanium/red,
/area/space)
"wo" = (
/turf/closed/wall/mineral/plastitanium,
/area/space)
"wV" = (
/obj/machinery/computer/helm/viewscreen/directional/north{
	name = "briefing monitor";
	desc = "A viewscreen for projecting visual aids during tactical briefings.."
	},
/turf/open/floor/plasteel/dark,
/area/space)
"xi" = (
/obj/structure/railing{
	dir = 1
	},
/turf/open/floor/plasteel/dark,
/area/space)
"yO" = (
/obj/machinery/door/airlock/grunge,
/turf/open/floor/plasteel/dark,
/area/space)
"zC" = (
/turf/open/floor/plasteel/dark,
/area/space)
"AO" = (
/turf/open/floor/plating/asteroid/whitesands/lit,
/area/space)
"Bc" = (
/obj/machinery/door/airlock/grunge{
	dir = 4
	},
/turf/open/floor/plasteel/dark,
/area/space)
"Bj" = (
/obj/structure/table/reinforced,
/obj/machinery/microwave,
/turf/open/floor/wood,
/area/space)
"BO" = (
/obj/effect/turf_decal/syndicateemblem/top/left,
/turf/open/floor/mineral/plastitanium/red,
/area/space)
"CZ" = (
/obj/structure/table/reinforced,
/obj/structure/window/reinforced{
	dir = 1
	},
/obj/structure/reagent_dispensers/servingdish,
/obj/item/shovel/spoon{
	name = "ladle";
	desc = "An overused, rusted ladle."
	},
/turf/open/floor/plasteel/dark,
/area/space)
"Dd" = (
/turf/open/floor/plasteel/stairs,
/area/space)
"Dg" = (
/obj/structure/table/reinforced,
/obj/structure/window/reinforced{
	dir = 1
	},
/obj/item/reagent_containers/glass/bowl{
	pixel_y = 3;
	w_class = 2
	},
/obj/item/reagent_containers/glass/bowl{
	pixel_y = 5;
	w_class = 2
	},
/obj/item/reagent_containers/glass/bowl{
	pixel_y = 7;
	w_class = 2
	},
/obj/item/reagent_containers/glass/bowl{
	pixel_y = 9;
	w_class = 2
	},
/turf/open/floor/plasteel/dark,
/area/space)
"Dv" = (
/obj/effect/turf_decal/industrial/warning{
	dir = 10
	},
/turf/open/floor/concrete,
/area/space)
"Eh" = (
/obj/structure/railing/corner{
	dir = 8
	},
/turf/open/floor/concrete/slab_1,
/area/space)
"EJ" = (
/obj/structure/table/reinforced,
/obj/item/cutting_board,
/obj/item/kitchen/knife/combat/survival,
/turf/open/floor/wood,
/area/space)
"Fu" = (
/turf/open/floor/mineral/plastitanium/red,
/area/space)
"GA" = (
/obj/structure/railing{
	dir = 10
	},
/obj/structure/table/reinforced,
/obj/item/megaphone/command,
/turf/open/floor/mineral/plastitanium,
/area/space)
"Jm" = (
/obj/structure/catwalk,
/obj/machinery/door/poddoor/shutters{
	dir = 4
	},
/turf/open/floor/plating,
/area/space)
"Jw" = (
/obj/machinery/door/airlock/centcom{
	aiControlDisabled = 1;
	name = "Assault Pod";
	req_access_txt = "150";
	dir = 4
	},
/turf/open/floor/plating/asteroid/whitesands/lit,
/area/space)
"Kk" = (
/obj/machinery/door/poddoor/shutters,
/turf/open/floor/mineral/plastitanium/red,
/area/space)
"Lj" = (
/obj/machinery/shuttle_manipulator,
/turf/open/floor/plasteel/dark,
/area/space)
"LQ" = (
/obj/structure/chair/comfy/beige/directional/south,
/turf/open/floor/plasteel/dark,
/area/space)
"Mw" = (
/obj/effect/turf_decal/industrial/warning{
	dir = 5
	},
/turf/open/floor/concrete,
/area/space)
"MT" = (
/obj/structure/mecha_wreckage/gygax/dark,
/turf/open/floor/mineral/plastitanium,
/area/space)
"Nx" = (
/obj/machinery/door/poddoor/shutters,
/turf/open/floor/plating,
/area/space)
"NV" = (
/obj/machinery/door/airlock/centcom{
	name = "Assault Pod";
	req_access_txt = "150"
	},
/turf/open/floor/plating,
/area/space)
"Ow" = (
/turf/open/floor/plasteel/stairs{
	dir = 8
	},
/area/space)
"OS" = (
/obj/structure/railing{
	dir = 4
	},
/turf/open/floor/concrete/slab_1,
/area/space)
"PJ" = (
/obj/effect/turf_decal/industrial/stand_clear/white{
	dir = 4
	},
/turf/open/floor/concrete,
/area/space)
"Qb" = (
/obj/effect/turf_decal/syndicateemblem/bottom/right,
/turf/open/floor/mineral/plastitanium/red,
/area/space)
"Qg" = (
/turf/open/floor/concrete,
/area/space)
"QT" = (
/obj/structure/railing/corner{
	dir = 4
	},
/turf/open/floor/concrete/slab_1,
/area/space)
"QZ" = (
/turf/open/space/basic,
/area/space)
"Re" = (
/obj/structure/railing/corner{
	dir = 4
	},
/turf/closed/mineral/random/whitesands,
/area/space)
"Rr" = (
/obj/machinery/door/airlock/centcom{
	name = "Assault Pod";
	req_access_txt = "150"
	},
/turf/open/floor/plating/asteroid/whitesands/lit,
/area/space)
"Rz" = (
/obj/structure/table/reinforced,
/obj/machinery/door/window{
	dir = 1
	},
/turf/open/floor/plasteel/dark,
/area/space)
"Sv" = (
/obj/structure/kitchenspike,
/turf/open/floor/plasteel/freezer,
/area/space)
"Tv" = (
/obj/structure/railing{
	dir = 4
	},
/turf/open/floor/mineral/plastitanium,
/area/space)
"Va" = (
/obj/structure/table/reinforced,
/turf/open/floor/plasteel/dark,
/area/space)
"Vc" = (
/turf/open/floor/concrete/slab_1,
/area/space)
"Wx" = (
/obj/structure/railing{
	dir = 8
	},
/turf/open/floor/concrete/slab_1,
/area/space)
"Xd" = (
/obj/structure/railing/corner{
	dir = 1
	},
/turf/open/floor/concrete/slab_1,
/area/space)
"Xy" = (
/obj/structure/table/reinforced,
/obj/machinery/reagentgrinder/constructed,
/turf/open/floor/wood,
/area/space)
"Yh" = (
/obj/structure/railing{
	dir = 1
	},
/turf/open/floor/concrete/slab_1,
/area/space)
"Zv" = (
/obj/effect/turf_decal/syndicateemblem/top/right,
/turf/open/floor/mineral/plastitanium/red,
/area/space)
"ZG" = (
/obj/machinery/door/poddoor/shutters,
/turf/open/floor/plasteel/dark,
/area/space)

(1,1,1) = {"
QZ
QZ
QZ
QZ
QZ
QZ
QZ
QZ
QZ
QZ
QZ
QZ
QZ
QZ
QZ
QZ
QZ
QZ
QZ
QZ
QZ
QZ
QZ
QZ
QZ
AO
AO
AO
AO
AO
AO
AO
AO
AO
AO
AO
AO
AO
AO
AO
AO
AO
AO
AO
AO
AO
AO
AO
AO
AO
AO
AO
AO
AO
AO
AO
AO
AO
AO
AO
AO
AO
AO
AO
AO
AO
AO
AO
AO
AO
AO
AO
AO
AO
AO
"}
(2,1,1) = {"
QZ
QZ
QZ
QZ
QZ
QZ
QZ
QZ
QZ
QZ
QZ
QZ
QZ
QZ
QZ
QZ
QZ
QZ
QZ
QZ
QZ
QZ
QZ
QZ
QZ
AO
AO
AO
AO
AO
AO
AO
AO
AO
AO
AO
AO
AO
AO
AO
AO
AO
AO
AO
AO
AO
AO
AO
AO
AO
AO
AO
AO
AO
AO
AO
AO
AO
AO
AO
AO
AO
AO
AO
AO
AO
AO
AO
AO
AO
AO
AO
AO
AO
AO
"}
(3,1,1) = {"
QZ
QZ
QZ
QZ
QZ
QZ
QZ
QZ
QZ
QZ
QZ
QZ
QZ
QZ
QZ
QZ
QZ
QZ
QZ
QZ
QZ
QZ
QZ
QZ
QZ
AO
nJ
nJ
nJ
nJ
nJ
nJ
nJ
nJ
nJ
nJ
nJ
nJ
nJ
nJ
nJ
nJ
nJ
nJ
nJ
nJ
nJ
nJ
nJ
nJ
nJ
nJ
nJ
AO
AO
AO
AO
AO
AO
AO
AO
AO
AO
AO
AO
AO
AO
AO
AO
AO
AO
AO
AO
AO
AO
"}
(4,1,1) = {"
QZ
QZ
QZ
QZ
QZ
QZ
QZ
QZ
QZ
QZ
QZ
QZ
QZ
QZ
QZ
QZ
QZ
QZ
QZ
QZ
QZ
QZ
QZ
QZ
QZ
AO
nJ
nJ
nJ
nJ
nJ
nJ
nJ
nJ
nJ
nJ
nJ
nJ
nJ
nJ
nJ
nJ
nJ
nJ
nJ
nJ
nJ
nJ
nJ
nJ
nJ
nJ
nJ
nJ
AO
AO
AO
AO
AO
AO
AO
AO
AO
AO
AO
AO
AO
AO
AO
AO
AO
AO
AO
AO
AO
"}
(5,1,1) = {"
QZ
QZ
QZ
QZ
QZ
QZ
QZ
QZ
QZ
QZ
QZ
QZ
QZ
QZ
QZ
QZ
QZ
QZ
QZ
QZ
QZ
QZ
QZ
QZ
QZ
AO
nJ
nJ
nJ
nJ
nJ
nJ
nJ
nJ
nJ
nJ
nJ
nJ
nJ
nJ
nJ
nJ
nJ
nJ
nJ
nJ
nJ
nJ
nJ
nJ
nJ
nJ
nJ
AO
AO
AO
AO
AO
AO
AO
AO
AO
AO
AO
AO
AO
AO
AO
AO
AO
AO
AO
AO
AO
AO
"}
(6,1,1) = {"
QZ
QZ
QZ
QZ
QZ
QZ
QZ
QZ
QZ
QZ
QZ
QZ
QZ
QZ
QZ
QZ
QZ
QZ
QZ
QZ
QZ
QZ
QZ
QZ
QZ
AO
nJ
nJ
nJ
nJ
nJ
nJ
nJ
nJ
nJ
nJ
nJ
nJ
nJ
nJ
nJ
nJ
nJ
nJ
nJ
nJ
nJ
nJ
nJ
nJ
nJ
nJ
nJ
fQ
fQ
fQ
fQ
fQ
fQ
fQ
fQ
fQ
fQ
fQ
fQ
fQ
fQ
fQ
fQ
fQ
fQ
fQ
fQ
fQ
AO
"}
(7,1,1) = {"
QZ
QZ
QZ
QZ
QZ
QZ
QZ
QZ
QZ
QZ
QZ
QZ
QZ
QZ
QZ
QZ
QZ
QZ
QZ
QZ
QZ
QZ
QZ
QZ
QZ
AO
nJ
nJ
nJ
nJ
nJ
nJ
nJ
nJ
nJ
nJ
nJ
nJ
nJ
nJ
nJ
nJ
nJ
nJ
nJ
nJ
nJ
nJ
nJ
nJ
nJ
nJ
nJ
fQ
Qg
Qg
Qg
Qg
Qg
Qg
Qg
Qg
Qg
Qg
Qg
Qg
Qg
Qg
Qg
Qg
Qg
Qg
Qg
fQ
AO
"}
(8,1,1) = {"
QZ
QZ
QZ
QZ
QZ
QZ
QZ
QZ
QZ
QZ
QZ
QZ
QZ
QZ
QZ
QZ
QZ
QZ
QZ
QZ
QZ
QZ
QZ
QZ
QZ
AO
nJ
nJ
nJ
nJ
nJ
nJ
nJ
nJ
nJ
nJ
nJ
nJ
nJ
nJ
nJ
nJ
nJ
nJ
nJ
nJ
nJ
nJ
nJ
nJ
nJ
nJ
nJ
fQ
Qg
vh
Qg
Qg
Qg
Qg
Qg
Qg
Qg
Qg
Qg
Qg
Qg
Qg
Qg
Qg
Qg
Dv
Qg
fQ
AO
"}
(9,1,1) = {"
QZ
QZ
QZ
QZ
QZ
QZ
QZ
QZ
QZ
QZ
QZ
QZ
QZ
QZ
QZ
QZ
QZ
QZ
QZ
QZ
QZ
QZ
QZ
QZ
QZ
AO
nJ
nJ
nJ
nJ
nJ
nJ
nJ
nJ
nJ
nJ
nJ
nJ
nJ
nJ
nJ
nJ
nJ
nJ
nJ
mh
mh
mh
mh
nJ
nJ
nJ
nJ
fQ
Qg
Qg
Qg
Qg
Qg
Qg
Qg
Qg
Qg
Qg
Qg
Qg
Qg
Qg
Qg
Qg
Qg
Qg
Qg
fQ
AO
"}
(10,1,1) = {"
QZ
QZ
QZ
QZ
QZ
QZ
QZ
QZ
QZ
QZ
QZ
QZ
QZ
QZ
QZ
QZ
QZ
QZ
QZ
QZ
QZ
QZ
QZ
QZ
QZ
AO
nJ
nJ
nJ
nJ
nJ
nJ
nJ
nJ
nJ
nJ
nJ
nJ
nJ
nJ
nJ
nJ
nJ
nJ
nJ
mh
mh
mh
mh
nJ
nJ
nJ
nJ
fQ
Qg
Qg
Qg
Qg
Qg
Qg
Qg
Qg
Qg
Qg
Qg
Qg
Qg
Qg
Qg
Qg
Qg
Qg
Qg
fQ
AO
"}
(11,1,1) = {"
QZ
QZ
QZ
QZ
QZ
QZ
QZ
QZ
QZ
QZ
QZ
QZ
QZ
QZ
QZ
QZ
QZ
QZ
QZ
QZ
QZ
QZ
QZ
QZ
QZ
AO
nJ
nJ
nJ
nJ
nJ
nJ
nJ
nJ
nJ
nJ
nJ
nJ
nJ
nJ
nJ
nJ
nJ
nJ
nJ
mh
mh
mh
mh
nJ
nJ
nJ
nJ
fQ
Qg
Qg
Qg
Qg
Qg
Qg
Qg
Qg
Qg
Qg
Qg
Qg
Qg
Qg
Qg
Qg
Qg
Qg
Qg
fQ
AO
"}
(12,1,1) = {"
QZ
QZ
QZ
QZ
QZ
QZ
QZ
QZ
QZ
QZ
QZ
QZ
QZ
QZ
QZ
QZ
QZ
QZ
QZ
QZ
QZ
QZ
QZ
QZ
QZ
AO
nJ
nJ
nJ
nJ
nJ
nJ
nJ
nJ
nJ
nJ
nJ
nJ
nJ
nJ
nJ
nJ
nJ
nJ
nJ
mh
mh
mh
mh
nJ
nJ
nJ
nJ
fQ
Qg
Qg
Qg
Qg
Qg
Qg
Qg
Qg
Qg
Qg
Qg
Qg
Qg
Qg
Qg
Qg
Qg
Qg
Qg
fQ
AO
"}
(13,1,1) = {"
QZ
QZ
QZ
QZ
QZ
QZ
QZ
QZ
QZ
QZ
QZ
QZ
QZ
QZ
QZ
QZ
QZ
QZ
QZ
QZ
QZ
QZ
QZ
QZ
QZ
AO
nJ
nJ
nJ
nJ
nJ
nJ
nJ
nJ
gB
gB
gB
gB
nJ
nJ
nJ
qp
nJ
nJ
nJ
mh
nZ
nZ
mh
nJ
nJ
nJ
nJ
fQ
Qg
Qg
Qg
Qg
Qg
Qg
Qg
Qg
Qg
Qg
Qg
Qg
Qg
Qg
Qg
Qg
Qg
Qg
Qg
fQ
AO
"}
(14,1,1) = {"
QZ
QZ
QZ
QZ
QZ
QZ
QZ
QZ
QZ
QZ
QZ
QZ
QZ
QZ
QZ
QZ
QZ
QZ
QZ
QZ
QZ
QZ
QZ
QZ
QZ
AO
nJ
nJ
nJ
nJ
nJ
nJ
nJ
nJ
gB
Va
wd
gB
gB
gB
gB
gB
nJ
nJ
nJ
gB
mh
mh
gB
nJ
nJ
nJ
nJ
fQ
Qg
Qg
Qg
Qg
Qg
Qg
Qg
Qg
Qg
Qg
Qg
Qg
Qg
Qg
Qg
Qg
Qg
Qg
Qg
fQ
AO
"}
(15,1,1) = {"
QZ
QZ
QZ
QZ
QZ
QZ
QZ
QZ
QZ
QZ
QZ
QZ
QZ
QZ
QZ
QZ
QZ
QZ
QZ
QZ
QZ
QZ
QZ
QZ
AO
AO
nJ
nJ
nJ
nJ
nJ
nJ
nJ
gB
gB
zC
zC
zC
zC
gX
qd
gB
gB
gB
gB
gB
mh
mh
gB
nJ
nJ
nJ
nJ
fQ
Qg
Qg
Qg
Qg
Qg
Qg
Qg
Qg
Qg
Qg
Qg
Qg
Qg
Qg
Qg
Qg
Qg
Qg
Qg
fQ
AO
"}
(16,1,1) = {"
QZ
QZ
QZ
QZ
QZ
QZ
QZ
QZ
QZ
QZ
QZ
QZ
QZ
QZ
QZ
QZ
QZ
QZ
QZ
QZ
QZ
QZ
QZ
QZ
QZ
QZ
nJ
nJ
nJ
nJ
nJ
nJ
nJ
gB
zC
zC
zC
zC
xi
gB
iF
Bj
gB
aY
Sv
gB
mh
mh
gB
nJ
nJ
nJ
nJ
fQ
Qg
Qg
Qg
Qg
Qg
Qg
Qg
Qg
Qg
Qg
Qg
Qg
Qg
Qg
Qg
Qg
Qg
Qg
Qg
fQ
AO
"}
(17,1,1) = {"
QZ
QZ
QZ
QZ
QZ
QZ
QZ
QZ
QZ
QZ
QZ
QZ
QZ
QZ
QZ
QZ
QZ
QZ
QZ
QZ
QZ
QZ
QZ
QZ
QZ
QZ
nJ
nJ
nJ
nJ
nJ
nJ
nJ
gB
zC
zC
zC
zC
xi
Dg
qd
EJ
gB
ea
ea
gB
mh
mh
gB
nJ
nJ
nJ
nJ
fQ
Qg
Qg
Qg
Qg
Qg
Qg
Qg
Qg
Qg
Qg
Qg
Qg
Qg
Qg
Qg
Qg
Qg
Qg
Qg
fQ
AO
"}
(18,1,1) = {"
QZ
QZ
QZ
QZ
QZ
QZ
QZ
QZ
QZ
QZ
QZ
QZ
QZ
QZ
QZ
QZ
QZ
QZ
QZ
QZ
QZ
QZ
QZ
QZ
QZ
QZ
nJ
nJ
nJ
nJ
nJ
nJ
gB
gB
zC
zC
zC
zC
xi
CZ
qd
Xy
gB
ea
ea
gB
mh
mh
gB
nJ
nJ
nJ
nJ
fQ
Qg
Mw
Qg
Qg
Qg
Qg
Qg
Qg
Qg
Qg
Qg
Qg
Qg
Qg
Qg
Qg
Qg
bc
Qg
fQ
AO
"}
(19,1,1) = {"
QZ
QZ
QZ
QZ
QZ
QZ
QZ
QZ
QZ
QZ
QZ
QZ
QZ
QZ
QZ
QZ
QZ
QZ
QZ
QZ
QZ
QZ
QZ
QZ
QZ
QZ
nJ
nJ
nJ
nJ
nJ
nJ
gB
zC
zC
zC
zC
zC
xi
Rz
qd
qd
jD
ea
ea
gB
mh
mh
gB
nJ
nJ
nJ
nJ
fQ
Qg
Qg
Qg
Qg
Qg
Qg
Qg
Qg
PJ
PJ
PJ
Qg
Qg
Qg
Qg
Qg
Qg
Qg
Qg
fQ
AO
"}
(20,1,1) = {"
QZ
QZ
QZ
QZ
QZ
QZ
QZ
QZ
QZ
QZ
QZ
QZ
QZ
QZ
QZ
QZ
QZ
QZ
QZ
QZ
QZ
QZ
QZ
QZ
QZ
QZ
nJ
nJ
nJ
nJ
nJ
nJ
gB
zC
zC
zC
zC
zC
zC
gB
gB
gB
gB
gB
gB
gB
mh
mh
gB
gB
gB
gB
gB
fQ
fQ
fQ
fQ
fQ
fQ
fQ
fQ
fQ
aE
Ow
tY
fQ
fQ
fQ
fQ
fQ
fQ
fQ
fQ
fQ
AO
"}
(21,1,1) = {"
QZ
QZ
QZ
QZ
QZ
QZ
QZ
QZ
QZ
QZ
QZ
QZ
QZ
QZ
QZ
QZ
QZ
QZ
QZ
QZ
QZ
QZ
QZ
QZ
QZ
QZ
nJ
nJ
nJ
nJ
nJ
nJ
gB
zC
zC
zC
zC
zC
mh
mh
kF
mh
mh
mh
mh
kF
mh
mh
Kk
BO
qD
gO
Nx
Wx
Wx
Wx
Wx
Wx
Wx
Wx
Wx
Wx
Xd
Vc
Eh
Wx
Wx
Wx
Wx
Wx
Wx
Wx
Wx
Wx
AO
"}
(22,1,1) = {"
QZ
QZ
QZ
QZ
QZ
QZ
QZ
QZ
QZ
QZ
QZ
QZ
QZ
QZ
QZ
QZ
QZ
QZ
QZ
QZ
QZ
QZ
QZ
QZ
QZ
QZ
nJ
nJ
nJ
nJ
nJ
nJ
gB
zC
zC
zC
zC
zC
mh
mh
kF
mh
mh
mh
mh
kF
mh
mh
Kk
cs
ni
wi
pI
Vc
Vc
Vc
Vc
Vc
Vc
Vc
Vc
Vc
Vc
Vc
Vc
Vc
Vc
Vc
Vc
Vc
Vc
Vc
Vc
Vc
AO
"}
(23,1,1) = {"
QZ
QZ
QZ
QZ
QZ
QZ
QZ
QZ
QZ
QZ
QZ
QZ
QZ
QZ
QZ
QZ
QZ
QZ
QZ
QZ
QZ
QZ
QZ
QZ
QZ
QZ
nJ
nJ
nJ
nJ
nJ
nJ
gB
zC
zC
zC
zC
zC
mh
mh
gB
gB
gB
gB
gB
gB
mh
mh
Kk
Zv
dq
Qb
Kk
OS
OS
OS
OS
OS
OS
OS
OS
OS
QT
Vc
nv
OS
OS
OS
OS
OS
OS
OS
OS
OS
AO
"}
(24,1,1) = {"
QZ
QZ
QZ
QZ
QZ
QZ
QZ
QZ
QZ
QZ
QZ
QZ
QZ
QZ
QZ
QZ
QZ
QZ
QZ
QZ
QZ
QZ
QZ
QZ
QZ
QZ
nJ
nJ
nJ
nJ
nJ
nJ
gB
gB
zC
zC
zC
zC
mh
mh
gB
nJ
nJ
nJ
nJ
gB
mh
mh
gB
kj
kj
gB
gB
fQ
fQ
fQ
fQ
fQ
fQ
fQ
fQ
fQ
Yh
Vc
kG
fQ
fQ
fQ
fQ
fQ
fQ
fQ
fQ
fQ
AO
"}
(25,1,1) = {"
QZ
QZ
QZ
QZ
QZ
QZ
QZ
QZ
QZ
QZ
QZ
QZ
QZ
QZ
QZ
QZ
QZ
QZ
QZ
QZ
QZ
QZ
QZ
QZ
QZ
QZ
nJ
nJ
nJ
nJ
nJ
nJ
nJ
gB
gB
zC
zC
zC
mh
mh
gB
nJ
nJ
nJ
nJ
gB
mh
mh
gB
mh
mh
gB
nJ
fQ
Qg
Qg
Qg
Qg
Qg
Qg
Qg
fQ
Yh
Vc
kG
fQ
Qg
Qg
Qg
Qg
Qg
Qg
Qg
fQ
AO
"}
(26,1,1) = {"
QZ
QZ
QZ
QZ
QZ
QZ
QZ
QZ
QZ
QZ
QZ
QZ
QZ
QZ
QZ
QZ
QZ
QZ
QZ
QZ
QZ
QZ
QZ
AO
gB
gB
gB
zC
gB
gB
gB
nJ
nJ
nJ
gB
gB
gB
gB
gB
gB
gB
nJ
nJ
nJ
nJ
gB
mh
mh
kF
mh
mh
gB
nJ
fQ
Qg
vh
Qg
Qg
Qg
Dv
Qg
fQ
Yh
Vc
kG
fQ
Qg
vh
Qg
Qg
Qg
Dv
Qg
fQ
AO
"}
(27,1,1) = {"
QZ
QZ
QZ
QZ
QZ
QZ
QZ
QZ
QZ
QZ
QZ
QZ
QZ
QZ
QZ
QZ
QZ
QZ
QZ
QZ
QZ
QZ
QZ
gB
gB
zC
zC
zC
zC
zC
gB
gB
nJ
nJ
gB
gB
zC
zC
zC
zC
gB
gB
nJ
nJ
nJ
gB
mh
mh
gB
gB
gB
gB
nJ
fQ
Qg
Qg
Qg
Qg
Qg
Qg
Qg
fQ
Yh
Vc
kG
fQ
Qg
Qg
Qg
Qg
Qg
Qg
Qg
fQ
AO
"}
(28,1,1) = {"
QZ
QZ
QZ
QZ
QZ
QZ
QZ
QZ
QZ
QZ
QZ
QZ
QZ
QZ
QZ
QZ
QZ
QZ
QZ
QZ
QZ
QZ
QZ
gB
zC
zC
zC
zC
zC
zC
zC
gB
gB
gB
gB
wV
zC
uh
uh
uh
zC
gB
nJ
nJ
nJ
gB
mh
mh
gB
nJ
nJ
nJ
nJ
fQ
Qg
Qg
Qg
Qg
Qg
Qg
Qg
fQ
Yh
Vc
kG
fQ
Qg
Qg
Qg
Qg
Qg
Qg
Qg
fQ
AO
"}
(29,1,1) = {"
QZ
QZ
QZ
QZ
QZ
QZ
QZ
QZ
QZ
QZ
QZ
QZ
QZ
QZ
QZ
QZ
QZ
QZ
QZ
QZ
QZ
QZ
QZ
gB
zC
LQ
Va
Va
Va
uj
zC
yO
zC
zC
Dd
zC
zC
uh
uh
uh
zC
gB
gB
gB
gB
gB
mh
mh
gB
nJ
nJ
nJ
nJ
fQ
si
Qg
Qg
Qg
Qg
Qg
nS
rs
Xd
Vc
Eh
ij
si
Qg
Qg
Qg
Qg
Qg
nS
fQ
AO
"}
(30,1,1) = {"
QZ
QZ
QZ
QZ
QZ
QZ
QZ
QZ
QZ
QZ
QZ
QZ
QZ
QZ
QZ
QZ
QZ
QZ
QZ
QZ
QZ
QZ
QZ
gB
zC
LQ
Va
Lj
Va
uj
zC
gB
zC
rs
pu
GA
Fu
Fu
Fu
Fu
Fu
kF
mh
mh
mh
kF
mh
mh
gB
nJ
nJ
nJ
nJ
fQ
si
Qg
Qg
Qg
Qg
Qg
nS
io
QT
Vc
nv
qk
si
Qg
Qg
Qg
Qg
Qg
nS
fQ
AO
"}
(31,1,1) = {"
QZ
QZ
QZ
QZ
QZ
QZ
QZ
QZ
QZ
QZ
QZ
QZ
QZ
QZ
QZ
QZ
QZ
QZ
QZ
QZ
QZ
QZ
QZ
gB
zC
LQ
Va
zC
Va
uj
zC
gB
zC
io
Tv
tt
Fu
Fu
Fu
Fu
Fu
kF
mh
mh
mh
kF
mh
mh
gB
nJ
nJ
nJ
nJ
fQ
Qg
Qg
Qg
Qg
Qg
Qg
Qg
fQ
Yh
Vc
kG
fQ
Qg
Qg
Qg
Qg
Qg
Qg
Qg
fQ
AO
"}
(32,1,1) = {"
QZ
QZ
QZ
QZ
QZ
QZ
QZ
QZ
QZ
QZ
QZ
QZ
QZ
QZ
QZ
QZ
QZ
QZ
QZ
QZ
QZ
QZ
QZ
gB
zC
LQ
Va
Va
Va
uj
zC
yO
zC
zC
Dd
zC
zC
uh
uh
uh
zC
gB
gB
gB
gB
gB
mh
mh
gB
nJ
nJ
nJ
nJ
fQ
Qg
Qg
Qg
Qg
Qg
Qg
Qg
fQ
Yh
Vc
kG
fQ
Qg
Qg
Qg
Qg
Qg
Qg
Qg
fQ
AO
"}
(33,1,1) = {"
QZ
QZ
QZ
QZ
QZ
QZ
QZ
QZ
QZ
QZ
QZ
QZ
QZ
QZ
QZ
QZ
QZ
QZ
QZ
QZ
QZ
QZ
QZ
gB
zC
zC
zC
zC
zC
zC
zC
gB
gB
gB
gB
wV
zC
uh
uh
uh
zC
gB
zC
zC
zC
gB
mh
mh
gB
nJ
nJ
nJ
nJ
fQ
Qg
Mw
Qg
Qg
Qg
bc
Qg
fQ
Yh
Vc
kG
fQ
Qg
Mw
Qg
Qg
Qg
bc
Qg
fQ
AO
"}
(34,1,1) = {"
QZ
QZ
QZ
QZ
QZ
QZ
QZ
QZ
QZ
QZ
QZ
QZ
QZ
QZ
QZ
QZ
QZ
QZ
QZ
QZ
QZ
QZ
QZ
gB
gB
zC
zC
zC
zC
zC
gB
gB
nJ
nJ
gB
gB
zC
zC
zC
zC
gB
gB
zC
zC
zC
gB
mh
mh
gB
nJ
nJ
nJ
nJ
fQ
Qg
Qg
Qg
Qg
Qg
Qg
Qg
fQ
Yh
Vc
kG
fQ
Qg
Qg
Qg
Qg
Qg
Qg
Qg
fQ
AO
"}
(35,1,1) = {"
QZ
QZ
QZ
QZ
QZ
QZ
QZ
QZ
QZ
QZ
QZ
QZ
QZ
QZ
QZ
QZ
QZ
QZ
QZ
QZ
QZ
QZ
QZ
AO
gB
gB
gB
Bc
gB
gB
gB
nJ
nJ
nJ
nJ
gB
gB
gB
gB
gB
gB
zC
zC
zC
zC
gB
mh
mh
gB
gB
gB
nJ
nJ
fQ
fQ
fQ
fQ
fQ
fQ
fQ
fQ
fQ
Yh
Vc
kG
fQ
fQ
fQ
fQ
fQ
fQ
fQ
fQ
fQ
AO
"}
(36,1,1) = {"
QZ
QZ
QZ
QZ
QZ
QZ
QZ
QZ
QZ
QZ
QZ
QZ
QZ
QZ
QZ
QZ
QZ
QZ
QZ
QZ
QZ
QZ
QZ
QZ
QZ
AO
gB
AO
AO
AO
AO
nJ
nJ
nJ
nJ
nJ
nJ
gB
mh
mh
zC
zC
zC
zC
zC
gB
mh
mh
zC
zC
gB
gB
nJ
Re
nJ
nJ
nJ
nJ
nJ
nJ
gB
gB
Jm
Jm
Jm
gB
gB
nJ
nJ
nJ
AO
AO
AO
AO
AO
"}
(37,1,1) = {"
QZ
QZ
QZ
QZ
QZ
QZ
QZ
QZ
QZ
QZ
QZ
QZ
QZ
QZ
QZ
QZ
QZ
QZ
QZ
QZ
QZ
QZ
QZ
QZ
QZ
AO
gB
AO
AO
AO
AO
nJ
nJ
nJ
nJ
nJ
nJ
gB
mh
mh
zC
zC
zC
zC
zC
gB
mh
mh
zC
zC
zC
gB
nJ
nJ
nJ
nJ
nJ
nJ
nJ
nJ
gB
zC
tk
tk
tk
gB
gB
gB
nJ
nJ
AO
AO
AO
AO
AO
"}
(38,1,1) = {"
QZ
QZ
QZ
QZ
QZ
QZ
QZ
QZ
QZ
QZ
QZ
QZ
QZ
QZ
QZ
QZ
QZ
QZ
QZ
QZ
QZ
QZ
QZ
QZ
QZ
AO
gB
AO
AO
AO
AO
nJ
nJ
gB
gB
gB
gB
gB
mh
mh
zC
zC
zC
zC
zC
gB
mh
mh
zC
zC
zC
gB
gB
gB
gB
gB
gB
gB
gB
gB
gB
zC
tk
tk
tk
ZG
MT
gB
nJ
nJ
AO
AO
AO
AO
AO
"}
(39,1,1) = {"
QZ
QZ
QZ
QZ
QZ
QZ
QZ
QZ
QZ
QZ
QZ
QZ
QZ
QZ
QZ
QZ
QZ
QZ
QZ
QZ
QZ
QZ
QZ
QZ
QZ
AO
gB
AO
AO
AO
AO
nJ
nJ
mh
mh
mh
mh
mh
mh
mh
mh
mh
mh
mh
mh
mh
mh
mh
mh
mh
mh
mh
mh
mh
mh
mh
mh
mh
mh
mh
mh
zC
tk
tk
tk
gB
gB
gB
nJ
nJ
AO
AO
AO
AO
AO
"}
(40,1,1) = {"
QZ
QZ
QZ
QZ
QZ
QZ
QZ
QZ
QZ
QZ
QZ
QZ
QZ
QZ
QZ
QZ
QZ
QZ
QZ
QZ
QZ
QZ
QZ
QZ
nJ
nJ
gB
nJ
nJ
nJ
nJ
nJ
nJ
mh
mh
mh
mh
mh
mh
mh
mh
mh
mh
mh
mh
mh
mh
mh
mh
mh
mh
mh
mh
mh
mh
mh
mh
mh
mh
mh
mh
zC
tk
tk
tk
ZG
MT
gB
nJ
nJ
AO
AO
AO
AO
AO
"}
(41,1,1) = {"
QZ
QZ
QZ
nJ
wo
wo
iE
wo
wo
nJ
QZ
QZ
QZ
QZ
QZ
QZ
QZ
QZ
QZ
QZ
QZ
QZ
QZ
QZ
nJ
nJ
gB
gB
gB
gB
gB
gB
gB
gB
gB
gB
gB
gB
gB
gB
gB
gB
gB
gB
gB
gB
zC
zC
zC
zC
zC
gB
gB
gB
gB
gB
gB
gB
gB
gB
gB
zC
tk
tk
tk
gB
gB
gB
nJ
nJ
AO
AO
AO
AO
AO
"}
(42,1,1) = {"
QZ
QZ
QZ
wo
wo
Fu
Fu
Fu
wo
wo
QZ
QZ
QZ
QZ
QZ
QZ
QZ
QZ
QZ
QZ
QZ
QZ
QZ
QZ
nJ
nJ
nJ
nJ
nJ
nJ
nJ
nJ
nJ
nJ
nJ
nJ
nJ
nJ
nJ
nJ
nJ
nJ
nJ
nJ
nJ
gB
zC
zC
zC
zC
zC
gB
nJ
nJ
nJ
nJ
nJ
nJ
nJ
nJ
gB
zC
tk
tk
tk
ZG
MT
gB
nJ
nJ
AO
AO
AO
AO
AO
"}
(43,1,1) = {"
QZ
QZ
QZ
wo
Fu
Fu
Fu
Fu
Fu
wo
QZ
QZ
QZ
QZ
QZ
QZ
QZ
QZ
QZ
QZ
QZ
QZ
QZ
QZ
nJ
nJ
nJ
nJ
nJ
nJ
nJ
nJ
nJ
nJ
nJ
nJ
nJ
nJ
nJ
nJ
nJ
nJ
nJ
nJ
nJ
gB
zC
zC
zC
zC
gB
gB
nJ
nJ
nJ
nJ
nJ
nJ
nJ
nJ
gB
zC
tk
tk
tk
gB
gB
gB
nJ
nJ
AO
AO
AO
AO
AO
"}
(44,1,1) = {"
QZ
QZ
QZ
NV
Fu
Fu
wo
Fu
Fu
NV
QZ
QZ
QZ
QZ
QZ
QZ
QZ
QZ
QZ
QZ
QZ
QZ
QZ
QZ
nJ
nJ
nJ
nJ
nJ
nJ
nJ
nJ
nJ
nJ
nJ
nJ
nJ
nJ
nJ
nJ
nJ
nJ
nJ
nJ
nJ
gB
gB
gB
gB
gB
gB
nJ
nJ
nJ
nJ
nJ
nJ
nJ
nJ
nJ
gB
gB
gB
gB
gB
gB
gB
nJ
nJ
hu
wo
Jw
wo
hu
AO
"}
(45,1,1) = {"
QZ
QZ
QZ
wo
nx
Fu
Fu
Fu
Fu
wo
QZ
QZ
QZ
QZ
QZ
QZ
QZ
QZ
QZ
QZ
QZ
QZ
QZ
QZ
nJ
nJ
nJ
nJ
nJ
nJ
nJ
nJ
nJ
nJ
nJ
nJ
nJ
nJ
nJ
nJ
nJ
nJ
nJ
nJ
nJ
nJ
nJ
nJ
nJ
nJ
nJ
nJ
nJ
nJ
nJ
nJ
nJ
nJ
nJ
nJ
nJ
nJ
nJ
nJ
nJ
nJ
nJ
nJ
hu
wo
Fu
Fu
Fu
wo
hu
"}
(46,1,1) = {"
QZ
QZ
QZ
hu
wo
Fu
Fu
Fu
wo
hu
QZ
QZ
QZ
QZ
QZ
QZ
QZ
QZ
QZ
QZ
QZ
QZ
QZ
QZ
nJ
nJ
nJ
nJ
nJ
nJ
nJ
nJ
nJ
nJ
nJ
nJ
nJ
nJ
nJ
nJ
nJ
nJ
nJ
nJ
nJ
nJ
nJ
nJ
nJ
nJ
nJ
nJ
nJ
nJ
nJ
nJ
nJ
nJ
nJ
nJ
nJ
nJ
nJ
nJ
nJ
nJ
nJ
nJ
wo
Fu
Fu
Fu
Fu
Fu
wo
"}
(47,1,1) = {"
QZ
QZ
QZ
AO
hu
wo
iE
wo
hu
AO
QZ
QZ
QZ
QZ
QZ
QZ
QZ
QZ
QZ
QZ
QZ
QZ
QZ
QZ
nJ
nJ
nJ
nJ
nJ
nJ
nJ
nJ
nJ
nJ
nJ
nJ
nJ
nJ
nJ
nJ
nJ
nJ
nJ
nJ
nJ
nJ
nJ
AO
AO
AO
AO
nJ
nJ
nJ
nJ
nJ
nJ
nJ
nJ
nJ
nJ
nJ
nJ
nJ
nJ
nJ
nJ
nJ
Rr
Fu
Fu
wo
Fu
Fu
Rr
"}
(48,1,1) = {"
QZ
QZ
QZ
QZ
QZ
QZ
QZ
QZ
QZ
QZ
QZ
QZ
QZ
QZ
QZ
QZ
QZ
QZ
QZ
QZ
QZ
QZ
QZ
QZ
nJ
nJ
nJ
nJ
nJ
nJ
nJ
nJ
nJ
nJ
nJ
nJ
nJ
nJ
nJ
nJ
nJ
nJ
nJ
nJ
nJ
nJ
nJ
AO
AO
AO
AO
nJ
nJ
nJ
nJ
nJ
nJ
nJ
nJ
nJ
nJ
nJ
nJ
nJ
nJ
nJ
nJ
nJ
wo
Fu
Fu
Fu
Fu
Fu
wo
"}
(49,1,1) = {"
QZ
QZ
QZ
QZ
QZ
QZ
QZ
QZ
QZ
QZ
QZ
QZ
QZ
QZ
QZ
QZ
QZ
QZ
QZ
QZ
QZ
QZ
QZ
QZ
nJ
nJ
nJ
nJ
nJ
nJ
nJ
nJ
nJ
nJ
nJ
nJ
nJ
nJ
nJ
nJ
nJ
nJ
nJ
nJ
nJ
nJ
nJ
AO
AO
AO
AO
AO
AO
AO
AO
AO
AO
AO
AO
AO
nJ
nJ
nJ
nJ
nJ
nJ
nJ
nJ
wo
wo
Fu
Fu
Fu
wo
wo
"}
(50,1,1) = {"
QZ
QZ
QZ
QZ
QZ
QZ
QZ
QZ
QZ
QZ
QZ
QZ
QZ
QZ
QZ
QZ
QZ
QZ
QZ
QZ
QZ
QZ
QZ
QZ
nJ
nJ
nJ
nJ
nJ
nJ
nJ
nJ
nJ
nJ
nJ
nJ
nJ
nJ
nJ
nJ
AO
AO
AO
nJ
nJ
nJ
nJ
AO
AO
AO
AO
AO
AO
AO
AO
AO
AO
AO
AO
AO
AO
AO
AO
AO
AO
AO
AO
AO
AO
wo
wo
Jw
wo
wo
AO
"}
